2004–	2004-
2007–	2007-
4o	40
9-1ágaš	9-lágaš
ASai	AS:i
Adjitt	Ádjit
Adjtskaidi	Ádjatskáidi
Afrihkkás	Afrihkás
Ahkkanasjohkii	Áhkkanasjohkii
Ahkoš	Áhkoš
Ahkožis	Áhkožis
Aigi	Áigi
Ailligas	Áilegas
Aisttorn	Aistton
Aitevárri	Áitevárri
Alaraudajoki	Alaraudanjoki
Alddut	Álddut
Algu	Álgu
Alitčohká	Alitčohka
Allaskuvl-las	Allaskuvllas
Alleknjárggas	Álletnjárggas
Allii	Alli
Allábasiidipmilbálvalus	Allabasiidipmilbálvalus
Altta	Álttá
Alttas	Álttás
Amerihka	Amerihká
Amerihkas	Amerihkás
Amerihkii	Amerihkkái
Ameriihka	Amerihká
Ameriikalaččaide	Amerihkálaččaide
Ameriikalaš	Amerihkálaš
Ameriikas	Amerihkás
Amtmannsnessii	Amtmannsnesii
Anar	Anár
Anaris	Anáris
Anatomalas	Anatomalaš
Andaras	Ándaras
Andaras-gállá	Ándaras-gállá
Andaras-vuoras	Ándaras-vuoras
Andaras-vuoras:	Ándaras-vuoras:
Andersenas	Andersenis
AnneBritt	Anne-Britt
Anárjoht	Anárjoga
Anárá	Anára
Apotehkka	Apoteahkka
Arkhangela	Arkangela
Arkhangelskas	Arkangelas
Artic	Arctic
Artihkkalistis	Artihkkalisttis
Artihkkela	Artihkkala
Askak	Aslak
Asla	Aslat
Assuorggebuollan	Ássuorggebuollán
Astejohka	Ástejohka
Astrids	Astridis
Asttoáigesearvi	Astoáiggesearvi
Atlánterábi	Atlántaábi
Attáma-	Áttáma-
Audon	Audun
Austalia	Australia
Avži	Ávži
Avžžhuhusa	Ávžžuhusa
Aŋgirepmosat	Áŋgirepmosat
Aŋŋel	Áŋŋel
Ašše	Ášše
Aššebáhpárat	Áššebáhpárat
Aššenamma	Áššenamma
Aššenr	Áššenr.
Ašši	Ášši
Badjelasás	Badjelasas
Badjit	Bajit
Bahccavuotna	Báhccavuotna
Bahkkejeaddjiŧ	Bahkkejeaddjit
Bajasšaddan	Bajásšaddan
Bajásčuožželeami	Bajásčuožžileami
Bajášaddan	Bajásšaddan
Bajáššaddan	Bajásšaddan
Banakas	Banakis
Banana	Banána
Barenst	Barents
Barenstguovlu	Barentsguovlu
Barentčállingottiin	Barentsčállingottiin
Barggidbellodat	Bargiidbellodat
Barggiidbellodaga	Bargiidbellodaga
Barggohisvuohta	Bargguhisvuohta
Bargiibellodaga	Bargiidbellodaga
Bargiibellodagas	Bargiidbellodagas
Bargiibellodat	Bargiidbellodat
Bargiibellodgain	Bargiidbellodagain
Bargiidabellodaga	Bargiidbellodaga
Bargiidbeallodaga	Bargiidbellodaga
Bargiidbeallodat	Bargiidbellodat
Bargiidbelldoat	Bargiidbellodat
Bargiidbelloat	Bargiidbellodat
Bargiidbellodag	Bargiidbellodaga
Bargiidbellodasa	Bargiidbellodaga
Bargiidbelloga	Bargiidbellodaga
Bargiidebellodagas	Bargiidbellodagas
Bas-Prinssáš	Bas-Prinssaš
Basseŋga	Basseaŋga
Bavtajohka	Bávttajohka
Bavttajohka	Bávttajohka
Beaivit	Beaivvit
Beaivvaš	Beaivváš
Beaivvás	Beaivváš
Bealjáščohkáid	Bealjáščohkaid
Beargena	Bergena
Beassa	Beassá
Beassašfestivalain	Beassášfestiválain
Beasán	Beasan
Beatless	Beatles
Beavi	Beaivi
Beazedievva	Beazedievvá
Beiavvášgieddi	Beaivvášgieddi
Bern-konvešuvnna	Bern-konvenšuvnna
Betales	Beatles
Bibala	Biibbala
Biddjovággái	Biedjovággái
Biddjovákki	Biedjovákki
Bidjovákkis	Biedjovákkis
Biebmobearraigeahču	Biebmobearráigeahču
Biebmostállama	Biepmostallama
Bieggomillorusttegiid	Bieggamillorusttegiid
Biehtar	Biehtár
Biepmustallama	Biepmostallama
Bihtta	Bihttá
Biiga	Biigá
Biilaindustria	Biilaindustriija
Birasgahttendepartemeanta	Birasgáhttendepartemeanta
Birasgahttendepartementta	Birasgáhttendepartemeantta
Birasgahttenministtar	Birasgáhttenministtar
Birasgáhttendeparte-meanta	Birasgáhttendepartemeanta
Birasspáiddár	Birasspáiddar
Bjerkviika	Bjerkvika
Bjerviika	Bjerkvika
Bjerviikas	Bjerkvikas
Blacksheeps	BlackSheeps
Boahte	Boahtte
Boaraseappot	Boarráseappot
Boaraseapput	Boarráseappot
Boarasiid	Boarrásiid
Boarraseamos	Boarráseamos
Boarraset	Boarráset
Boarrasit	Boarrásit
Boasttubeal	Boasttubeale
Boazo	Boazu
Boazodaollolága	Boazodoallolága
Boazodoallo	Boazodoallu
Boazodoallošiehtádusain	Boazodoallošiehtadusain
Boazodoalluhálddahus	Boazodoallohálddahus
Boazodoalluhálddáhus	Boazodoallohálddahus
Boazodoalošiehtádusa	Boazodoallošiehtadusa
Boazopoliijat	Boazopolitiijat
Bodeaju	Budejju
Bodeajus	Budejjus
Bodedju	Bodeadju
Bohtál	Bohtal
Boraspirevátttisvuohta	Boraspireváttisvuohta
Borádit	Boradit
Boršejávrriŧ	Boršejávrrit
Bossegohpii	Bossogohppái
Bovsta	Bovccá
Brasiila	Brasila
Brasiilas	Brasilas
Buletjavri	Buletjávri
Bulgaralaš	Bulgárialaš
Buoddun	Buođđun
Buodu	Buođu
Buorimus	Buoremus
Buorredáhttulašvuođa	Buorredáhtolašvuođa
Buorresárku	Boaresárku
Buresivdniduvvon	Buressivdniduvvon
Buris	Bures
Burjáhtalaš	Burjáhtialaš
Burjátias	Burjatias
Buseahttareguleren	Bušeahttareguleren
Bágadalli	Bagadalli
Bágadallit	Bagadallit
Bátnedoktárabálvalus	Bátnedoavttirbálvalus
Bággolonistanvuoigatvuodavuoddu	Bággolonistanvuoigatvuođavuođđu
Báhcajeagil	Báhčajeagil
Báhccajeagil	Báhčajeagil
Báhcánjeagil	Báhčajeagil
Báhkkilvárri	Báhkilvárri
Báicce	Baicce
Báicco	Baicce
Báika	Baika
Báisduoddara	Báišduoddara
Báktebohkka	Báktebohkká
Báktevuoigatvuodaid	Báktevuoigatvuođaid
Báktevuoigatvuodat	Báktevuoigatvuođat
Bálkášupmi	Bálkkašupmi
Bárgosadji	Bargosadji
Bártnážát	Bártnážat
Bávttavuolesjávrai	Bávttavuolesjávrái
Bårsejåkka	Borsejohka
Bæive	Bæivi
Cabarets	Cabaretas
Celkejuvvo	Celkojuvvo
Chiapasas	Chiapasis
Chrrister	Christer
Coctail	Cocktail
Coggalehppet	Coggalehpet
Commišuvdna	Kommišuvdna
Cunučearru	Čunočearru
Cuovvovaccat	Čuovvovaččat
Cuovvovaš	Čuovvovaš
Cup:a	Cupa
Cupai	Cupii
Da	Dá
Dagbladis	Dagbladetis
Dagbláđđai	Dagbladetii
Dagsreyenis	Dagsrevyenis
Dakŋásat	Dakŋasat
Dallu	Dállu
Dalošvákkis	Dálošvákkis
Danna	Dainna
Darogiel	Dárogiel
Davas	Davás
Davve-Ámeriikka	Davvi-Amerihkká
Davveoarje	Davveoarji
Davvioarjje-Ruoššain	Davvioarje-Ruoššain
Davvi-Amerihka	Davvi-Amerihká
Davvi-Ameriikas	Davvi-Amerihkás
Davvi-Kyprosas	Davvi-Kyprosis
DavviNorgga	Davvi-Norgga
Davvirikkaid	Davviriikkaid
Dađibáhabut	Dađibahábut
Deadnogáttis	Deatnogáttis
Deaiv-vadat	Deaivvadat
Dealdda	Dieldda
Dearvuođaiguinl	Dearvuođaiguin
Deavkehanjohkii	Deavkkehanjohkii
Deháleammos	Deháleamos
Dehálšamoš	Deháleamos
Denodagas	Deanodagas
Depermeanta	Departemeanta
Diehtelasat	Diehttelasat
Diehtetmeahttun	Diehtemeahttun
Dienna	Dieppe
Dievdolbmot	Dievdoolbmot
Dievdolmmoš	Dievdoolmmoš
Dig-forsk	Digforsk
Diggeoasseváldiŧ	Diggeoasseváldit
Diggeálbmoŧ	Diggeálbmot
Diibma	Diibmá
Diihten	Dihten
Diistaga	Disdaga
Divddasvuona	Divttasvuona
Divrrat	Divrrát
Divtasvuona	Divttasvuona
Divtasvuonas	Divttasvuonas
Divvumaŧ	Divvumat
Doaivvon	Doaivvun
Doaivvošiige	Doivvošiige
Doavddán	Dovddan
Dohkketmeahtun	Dohkketmeahttun
Dovddán	Dovddan
Dubmekeahttái	Dubmekeahttá
Duhtátjagiulbmilat	Duhátjagiulbmilat
Duodaid	Duođaid
Duodje	Duodji
Duogaš	Duogáš
Duojárid	Duojáriid
Duolbmukeahttá	Duolmmokeahttá
Duopmar	Duopmár
Duođa-štuvvon	Duođaštuvvon
Durkkihanvarri	Durkkihanvárri
Durkkihaváris	Durkkihanváris
Dutkosistis	Dutkosisttis
Duŧkamat	Dutkamat
Dáddárráđi	Dáiddárráđi
Dáhkadusásahusat	Dáhkádusásahusat
Dáiddáseminára	Dáiddaseminára
Dálbmeluoktá	Dálbmeluokta
Dálkkiha	Dalkkiha
Dálmmás	Dálmmas
Dálve-Olympiija	Dálveolympiija
Dánsesdehpet	Dánsestehpet
Dáruiduhttema	Dáruiduhttima
Dáruiduhttenfámut	Dáruiduhttinfámut
Dáruiduhttenpolitihkka	Dáruiduhttinpolitihkka
Dássažii	Dássážii
Dásseárvo	Dásseárvu
Dássožii	Dassážii
Dásá	Dasa
Dávvi	Davvi
Dávviorvuorkkain	Dávvirvuorkkáin
Dávvirvuorkáid	Dávvirvuorkkáid
Dávvi-Romssa	Davvi-Romssa
Dávvipovla	Davvipovla
Dørun	Dørum
E-paosta	E-poasta
EU-doarjjut	EU-doarjut
Eahkdismállásat	Eahkedismállásat
Eahpikeahttá	Eahpitkeahttá
Eahpitheahttá	Eahpitkeahttá
Ealisabeth	Elisabeth
Ealuigun	Ealuiguin
Ealahusovddideapmi	Ealáhusovddideapmi
Eanadalit	Eandalii
Eanadateknologiija	Eanadatteknologiija
Eanadoallošiehtádus	Eanadoallošiehtadus
Eanaeaiggáŧ	Eanaeaiggát
Eanaháldduŧ	Eanahálddut
Eanamiid	Eatnamiid
Eanandoalloálggahandoaimmaŧ	Eanandoalloálggahandoaimmat
Eanandoallpdepartementtas	Eanandoallodepartemeanttas
Eanemušain	Eanemusain
Eara	Eará
Earenoamažit	Earenoamážit
Eatnamsearvi	Eatnansearvi
Eaŋgelas	Eŋgelas
Eca	Eva
Eckerôas	Eckerös
Eearret	Earret
Eiseváldiin	Eiseválddiin
Ellern	Ellen
Elliinài	Elliinai
Enenezer	Ebenezer
Ere-noamážit	Erenoamážit
Erlad	Erland
Esctasy	Ecstasy
Espánjjagiela	Espánnjagiela
Europás	Eurohpás
Evttohuš	Evttohus
Eŋgelánda	Englánda
Eŋgelándda	Englándda
Eŋgelánddas	Englánddas
FInnmárkku	Finnmárkku
Fagagirječálliid	Fágagirječálliid
Fatnuid	Fádnuid
Favrresorda	Fávrresorda
Favrrumus	Fávrrumus
Feastonuohtiin	Feastonuhtiin
Fefte	Feste
Feltassisteantakurssa	Fealtaassisteantakurssa
Fiervva	Fiervvá
Fiijii	Fijii
Filbmagavpot	Filbmagávpot
Filipiinnaid	Filippiinnaid
Final	Finála
Finnmarkshállas	Finnmarkshallenis
Finnmrkku	Finnmárkku
Finnmrkkus	Finnmárkkus
Finnmrku	Finnmárku
Finnmáerkkuláhka	Finnmárkoláhka
Finnmákku	Finnmárkku
Finnmárkkukommišuvnda	Finnmárkkukommišuvdna
Finnámrkku	Finnmárkku
Finnámrkkus	Finnmárkkus
Fjeringsby	Fjerdingby
Foslet	Hvoslef
Friddagirku	Friddjagirku
Fuomašiin	Fuomášin
Fuomašuhttit	Fuomášuhttit
Fuoskus	Fuoskkus
Fuse	Fause
Fylkkadikkeáirrasat	Fylkkadiggeáirasat
Fysioterapiijaossadat	Fysioterapiijaossodat
Fábmu	Fápmu
Fágalaccat	Fágalaččat
Fámuhuhttejuvvon	Fámuhuhttojuvvon
Fánasgieddis	Fanasgiettis
Fápmuduš	Fápmudus
Fávrosorda	Fávrrosorda
Fávrosordda	Fávrrosordda
GLR:ai	GLR:i
Gahcahatvuoigatvuodat	Gahčahatvuoigatvuođat
Gaimmatvuovdi	Galmmatvuovdi
Galanitu	Gálaniitu
Galga	Galgá
Galggaši	Galggašii
Gamehiseana	Gámehiseana
Gaoppašiid	Goappašiid
Gargiijá	Gargia
Gargijái	Gargiai
Garigasnjárgga	Gáregasnjárgga
Garrajåkka	Garrajohka
Gartnetluohkká	Gártnetluohkká
Gaska-Ameriikas	Gaska-Amerihkás
Gaskái	Gaskii
Gasska	Gaska
Gasska-Nordlándda	Gaska-Nordlándda
Gaupai	Gaupii
Geahčanveara	Geahččanveara
Geaidnodoaimmahaŧ	Geaidnodoaimmahat
Geaidnoossodaŧ	Geaidnoossodat
Geaimmujohka	Geaimmejohka
Geatnegáhttá	Geatnegahttá
Geavgná	Geavgŋá
Genev:as	Geneves
Geomehtralaš	Geometralaš
Gi	Gii
Giellaguovddá_	Giellaguovddáš
Giljobašat	Giljobaččat
Ginsbergga	Ginsberga
Girdisealskáhpat	Girdiselskáhpat
Girjjálašvuoa	Girjjálašvuođa
Girjjáča	Girjjáža
Girkonjár	Girkonjárgga
Gnddat	Gánddat
Goahtegerret	Goahtegearret
Goahttegearrega	Goahtegearrega
Goalmmat	Goalmmát
Goađáŧ	Goađát
Goaŧáhusvihki	Goaŧohisvihki
Goddejávrai	Goddejávrái
Golfklubbas	Golfaklubbas
Golmmá	Golmma
Gonagasreabbáid	Gonagasreappáid
Gonagassa	Gonagasa
Gorvvejávris	Gorvvejávrris
Gouvdageainnu	Guovdageainnu
Gouvdageainnus	Guovdageainnus
Govddášnissoniid	Guovddášnissoniid
Govvijeaddji	Govvideaddji
Greanpeace	Greenpeace
Greenpeaca	Greenpeace
Gråven	Growen
Grønum	Grønnum
Guhkesnárga	Guhkesnjárga
Guhta	Guhtta
Guktut	Guktot
Guldealeaddjit	Guldaleaddjit
Guoladaga	Guoládaga
Guoladága	Guoládaga
Guoldaga	Guoládaga
Guollebiebmanealáhuš	Guollebiebmanealáhus
Guollebivdovuoigatvuoda	Guollebivdovuoigatvuođa
Guolleboránis	Guolleboranis
Guolástusdirektorahta	Guolástusdirektoráhtta
Guovageainnu	Guovdageainnu
Guovdagainnu	Guovdageainnu
Guovdageaidnulačči	Guovdageaidnulažžii
Guovdageainni	Guovdageainnu
Guovdageainnnu	Guovdageainnu
Guovdageainnulaš	Guovdageaidnulaš
Guovdageiannus	Guovdageainnus
Guovdageidnulačči	Guovdageaidnulažžii
Guovdageidnu	Guovdageaidnu
Guovdageinnu	Guovdageainnu
Guovdageinnus	Guovdageainnus
Guovddášbelodat	Guovddášbellodat
Guovddášdoaimmadat	Guovddášdoaimmahat
Guovdo	Guovdu
Guovllasttin	Guovllastin
Guovlluhistorjja	Guovlluhistorjjá
Gurbesvuovdi	Gurbbešvuovdi
Gurbmutvuobmi	Gurpmotvuopmi
Guvddatmohkis	Čoavddatmohkis
Guvodageainnu	Guovdageainnu
Gáissáá	Gáissá
Gáit	Gait
Gáivuinas	Gáivuonas
Gáivuoina	Gáivuona
Gáivuonjoavku	Gáivuonajoavku
Gálddooaivvi	Gáldooaivvi
Gámásuoidnegánddaiguin	Gámasuoidnegánddaiguin
Gárasávvona	Gárasavvona
Gáresavvona	Gárasavvona
Gáresávvonis	Gárasavvonis
Gárgovárrai	Gárgovárrái
Gáržžideamiŧ	Gáržžideamit
Gáttan	Gáttán
Gáttatban	Gáttátban
Gáttatgo	Gáttátgo
Gávpenjuolggadusaŧ	Gávpenjuolggadusat
Gávávži	Gávvávži
Gáŋgaviikas	Gáŋgaviikkas
Gáŋgáviika	Gáŋgaviika
Gážaldagat	Gažaldagat
Haetta	Hætta
Haga:i	Hagai
Hagene	Hagena
Halone	Halonen
Hamburggas	Hamburgas
Hammarfeastta	Hámmárfeastta
Hammerfeastas	Hámmárfeasttas
Hámmirfeasta	Hámmárfeasta
Hannela	Hannele
Harjanán	Hárjánan
Hasviika	Hasvik
Hasviikkas	Hasvikas
Haŋŋa	Haŋŋá
Healuimet	Heajuimet
Heandrat	Heandarat
Hearjjága	Hearjjaga
Heastavuoddjimat	Heastavuodjimat
Heattá	Heatta
Heikk-Elle	Heikka-Elle
Heikk-Elles	Heikka-Elles
Heittet	Heitet
Helnner	Hellner
Henrinsen	Henriksen
Historjjalaččat	Historjjálaččat
Hollánddalaš	Hollándalaš
Hologalándda	Hålogalándda
Humaetihkkáriid	Humanetihkkáriid
Humanistalaš	Humanisttalaš
Huskyis	Huskys
Huvärinen	Hyvärinen
Hábmiris	Hápmiris
Hálddahuslaccat	Hálddahuslaččat
Hálddádus	Hálddahus
Hámmerfeastas	Hámmárfeasttas
Hámmárfesttii	Hámmárfestii
Hánnoluohkka	Hánnoluohká
Hålogalandda	Hålogalánda
Hålogalanddas	Hålogalánddas
Hålogland	Hålogaland
Hålogolándda	Hålogalándda
Håvardl	Håvard
Hætt	Hætta
IF:ai	IF:i
ILO-konvešuvnna	ILO-konvenšuvnna
ILO-šiehtadussi	ILO-šiehtadussii
Iesjohtjoavku	Iešjotjoavku
Iešjoht	Iešjoga
Iešjohtjoavku	Iešjotjoavku
Iešjárluntta	Iešjárlunttat
Iešjávrai	Iešjávrái
Ihko	Itgo
Ikkáldas	Ikkaldas
Ikkáldasas	Ikkaldasas
Ilisai	Ilisii
Imáštalat	Imaštalat
InfoNuorra	Infonuorra
Ingir	Iŋgir
Ingira	Iŋgira
Ingirii	Iŋgirii
Ingiris	Iŋgiris
Ingrebrigt	Ingebrigt
Internáhttá	Internáhtta
Internšunála	Internašunála
Intrique	Intrigue
Ipmel	Ipmil
Iráka	Iraka
Issaht	Issát
Itálija	Itália
Ivgogákti	Ivgu-gákti
Ivgogávttis	Ivgu-gávttis
Ivgoheasta	Ivguheasta
Ivgoheasttain	Ivguheasttain
Ivgos	Ivgus
Ivniiguin	Ivnniiguin
Iŋga	Iŋgá
JOhan	Johan
Jaglandda	Jaglanda
Jahkedieđahusastis	Jahkedieđáhusastis
Jakutija	Jakutia
Jesos	Jesus
Jieastanstivra	Jienastanstivra
Jietnja	Jiekŋa
Jille-Njaarke	Jillen-Njaarke
Joatkas	Joatkkas
Joatkaskuvla	Joatkkaskuvla
Joatkaskuvlla	Joatkkaskuvlla
Joatkaskuvllas	Joatkkaskuvllas
Joatkaskuvllat	Joatkkaskuvllat
Joavkojođiheaddjide	Joavkojođiheddjiide
Joavkočiekačan	Joavkočiekčan
Joccástalai	Joccastalai
Jogos	Jogo
Johskareng	Johnskareng
Johtulatlávde	Johtolatlávde
Johtulatsuorggi	Johtolatsuorggi
Johttisapmelaččaid	Johttisápmelaččaid
Jompanen	Jomppanen
Jortamor	Jortamovra
Juigamus	Juoigamuš
Julev-Youtube	Julev-YouTube
Julevsame	Julevsáme
Julis	Julius
Juohkinkeahttá	Juogakeahttá
Juoiga	Juoigá
Juornalisttaid	Journalisttaid
Jussaŧ	Jussá
Justisdepartementta	Justiisadepartemeantta
Juvddáláččat	Juvddálaččat
Jámolaš-vuohta	Jámolašvuohta
Jávo	Javo
Jávrrahašmohkki	Jávrrehašmohkki
Jønnson	Jønsson
Kainna	Kaina
Kalaalit	Kalaallit
Karasjoga	Kárášjoga
Karlstrõm	Karlström
Karášjoga	Kárášjoga
Karášjogas	Kárášjogas
Kategoriafáktor	Kategoriijafáktor
Kernmo	Kvernmo
Kiinás	Kiinnás
Kinalaččat	Kiinnálaččat
Kiná	Kiinná
Kistránddas	Kistrandas
Kiuna	Kiruna
Kjellman	Kjellmann
Kommunistalaš	Kommunisttalaš
Konfirmanttaid	Konfirmánttaid
Konfirmášuvdna	Konfirmašuvdna
Konklusuvdna	Konklušuvdna
Korpilähte	Korpilähde
Kristiansánddas	Kristiansandas
Kulturmuittuŧ	Kulturmuittut
Kuoljak	Kuoljok
Kvasshag	Kvasshaug
Kvesullos	Kvæøyas
Kyprosas	Kyprosis
Kárášjoht	Kárášjoga
Kárášjot	Kárášjoga
Kárášoga	Kárášjoga
Káráššjoga	Kárášjoga
Káršjogas	Kárášjogas
Káršájoga	Kárášjoga
Káršájogas	Kárášjogas
Káršájohka	Kárášjohka
Københammanis	Københámmanis
Københápmanis	Københámmanis
LaMK	LaMk
Lagabuid	Lagabui
Lansaman	Länsman
Lašmahallan	Lášmmohallan
Leavdja	Leavdnja
Leavdjá	Leavdnja
Leavdnjas	Leavnnjas
Leavdnjá	Leavdnja
Leavnjas	Leavnnjas
Leavnjja	Leavnnja
Leavnjjas	Leavnnjas
Leavssejohka	Leavššejohka
Legenbargu	Leŋgenbargu
Lehtet	Lehpet
Leimet	Leimmet
Lemaha	Lemeha
Lenta	Länta
Liihkku	Lihkku
Lillestrømma	Lillestrøma
Lillestrømmas	Lillestrømas
Lillestrømmii	Lillestrømii
Lilletunai	Lilletunii
Lindbeack	Lindbeck
Linkunjávrái	Liŋkonjávrái
Linnjáfierpmádaŧ	Linnjafierpmádat
Livzavihki	Livzávihki
Livzzavihkái	Livzávihkái
Lišmajok	Lišmmajohka
Loabagis	Loabágis
Loabakáiddi	Loabákáiddi
Loabáid	Loabágiid
Loahppakonsonáttat	Loahppakonsonánttat
Lodejeaddjis	Loddejeaddjis
Lodiga	Lodigiid
Logaldallamistis	Logaldallamisttis
Lohppačiekčamat	Loahppačiekčamat
Luhter	Luther
Lujvrri	Lujávrri
Lujvrris	Lujávrris
Lujávrelaš	Lujávrilaš
Lujávrres	Lujávrris
LulliRomssas	Lulli-Romssas
LuoktaMavas	Luokta-Mavas
Luonddgáhttensearvvi	Luonddugáhttensearvvi
Luonddogáhttejeaddjit	Luonddugáhttejeaddjit
Luonddogáhttensearvi	Luonddugáhttensearvi
Luonddugáhtensearvi	Luonddugáhttensearvi
Luopmánid	Luopmániid
Luostat	Luosttat
Luostejohk	Luostejohka
Lysingbláđis	Lysingsbladas
Lábbájoht	Lábbájohka
Lágabui	lagabui
Lákcájieŋa	Lákcajieŋa
Lákkovuon	Lákkovuona
Lássin	Lassin
Lássagámmi	Lásságámmi
Lávsdegottis	Lávdegottis
Lášmmohallanbasseŋga	Lášmmohallanbasseaŋga
MAy	May
Maastericht-šiehtadusa	Maastricht-šiehtadusa
Mackbeth	Macbeth
Maggá	Magga
Maghild	Magnhild
Magnhilld	Magnhild
Mahtisen	Mathisen
Mahtte	Máhtte
Mailevađđa	Máilevađđa
Manabajskaidi	Mánabaiskáidi
Manassei	Manassii
Mancester	Manchester
Mannjilgaskabeaivi	Maŋŋilgaskabeaivi
Manty	Mänty
Manŋimuš	Maŋimuš
Marehis	Márehis
Maret	Máret
Margarehte	Margarethe
Marjjábeaivvi	Márjjábeaivvi
Markanis	Márkanis
Maskevarre	Máskevárri
Maurlad	Maurstad
Maze	Máze
Maŋumustá	Maŋimustá
Maŋŋeseattes	Maŋŋeseahtas
Maŋŋičavčča	Maŋŋečavčča
Meahcce	Meahcci
Meahccedoalloministerjiija	Meahccedoalloministeriija
Meahccedoalloministerjiijjas	Meahccedoalloministeriijas
Meahceallit	Meahcieallit
Meannudemit	Meannudeamit
Mearradoalloealáhuš	Mearradoalloealáhus
Mearradusat	Mearrádusat
Meksikoas	Meksikos
Menchou	Menchu
Menhcú	Menchú
Mieleavttos	Mieleavttus
Miellahttut	Miellahtut
Mieronjavri	Mierojávri
Miesesmánu	Miessemánu
Mieđihán	Mieđihan
Mihtádusvuoigavuohta	Mihtidanvuoigatvuohta
Miin	Min
Millijuvnna	Millijovnna
Minaralutvikling	Mineralutvikling
Mineralutviklig	Mineralutvikling
Moatte	Moatti
Modella	Modealla
Mokkesáivii	Mohkkesáivii
Mollesjohka	Mollešjohka
Morrotaja	Morottaja
Moskavuon	Moskavuona
Movttidahttejit	Movttiidahttet
Muhtu	Muhto
Muhtu-massii	Muhtumassii
Mujhto	Muhto
Munje	Munnje
Muohto	Muhto
Muoidonvarbuollan	Muoidunvárbuollán
Muorralčázádaŧ	Muorralčázádat
Muosat	Muosát
Muttursykkelat	Mutursykkelat
Muturfievro	Muturfievru
Myllalä	Myllylä
MÁRKÁ	MÁRJÁ
Máhkárávju	Máhkarávju
Máilbme	Máilmme
Mákkar	Makkár
Mákkarávjui	Máhkarávjui
Mánaid	Mánáid
Mánga	Máŋga
Mánáguovttus	Mánáguovttos
Márjjážá	Márjjáža
Márkasámit	Márkosámit
Másjohka	Máskejohka
Mátke	Mátkke
Mátkkoštuseláhus	Mátkkoštusealáhus
Mátta-Várjaga	Mátta-Várjjaga
Máttá-Trøndelága	Mátta-Trøndelága
Máttá-Várjjaga	Mátta-Várjjaga
Máttá-Várjjagis	Mátta-Várjjagis
Máttá-Várjjat	Mátta-Várjjat
Máŋemus	Maŋemus
Máŋimuš	Maŋimuš
Máŋŋá	Maŋŋá
Máhttupárkii	Máhttopárkii
NIls	Nils
NSR:ai	NSR:i
Naka-mura	Nakamura
Namsriektái	Nammariektái
Narviikas	Narvikas
Navajo-reservahtas	Navajo-reserváhtas
Navajoat	Navajot
Navuona	Návuona
Našuvnnalš	Našuvnnalaš
Neaktarat	Neaktárat
Neavttarat	Neavttárat
Nenettsa	Nenetsa
Niemelæ	Niemelä
Niemila	Niemelä
Niitovuopi	Niitovuopio
Niitovuoppio	Niitovuopio
Niitošjoga	Niittošjoga
Niitošjogas	Niittošjogas
Niitošjogaš	Niittošjogas
Niityvuopio	Niittyvuopio
Nissonkonferána	Nissonkonferánsa
Nittyvuopio	Niittyvuopio
Njargasas	Njárgasaš
Njealjje	Njeallje
Njealjji	Njealji
Njealjját	Njealját
Njealljis	Njealjis
Njeallját	Njealját
Njereveaji	Njeareveaji
Njuorggimas	Njuorggámis
Njuorggánii	Njuorggámii
Njuorggániin	Njuorggámiin
Njávdamis	Njávdámis
Njávddáma	Njávdáma
Njávdánis	Njávdámis
Nohkkastit	Nohkastit
Nohkohalaimet	Nohkkohalaimet
Nonsrichzi	Nonsrichai
Noradas	Noradis
Noraidkonsuleanta	Nuoraidkonsuleanta
Norbottenis	Norrbottenis
Nordkahppii	Nordkáhppii
Nordlandda	Nordlándda
Norgag	Norgga
Norgags	Norggas
Norggaáittárdeaddji	Norggaáittardeaddji
Nostalgiia	Nostalgiija
Nousoniemi	Nousuniemi
Novdal	Nordal
Numeralaš	Numerálalaš
Nuorta-Sibirjás	Nuorta-Sibirjjás
Nuortaráissas	Nuorta-Ráissas
Nuortasievju	Nuorta-Sievju
Nuppastuhttinprográmma	Nuppástuhttinprográmma
Nuppážii	Nuppádis
Nuvtta	Nuvttá
Nystøai	Nystøi
Nystøii	Nystøi
Náranas	Náránaš
Náranaša	Náránačča
Náranašas	Náránaččas
Nárranaš	Náránaš
Návda	Navdá
Näkkeljoga	Neahčiljoga
Näkkeläjärvi	Näkkäläjärvi
Oahpahepmit	Oahpaheamit
Oahpahusfálaldagid	Oahpahusfálaldagaid
Oahpahusmininsteriija	Oahpahusministeriija
Oahpahusminsteriijas	Oahpahusministeriijas
Oahpahussurggis	Oahpahussuorggis
Oahpahusvearsttás	Oahpahusvearstás
Oahpeheaddji	Oahpaheaddji
Oahpit	Oahppit
Oahppofáláldagas	Oahppofálaldagas
Oaidnitmeahttun	Oaidnemeahttun
Oaidnáleapmái	Oaidnaleapmái
Oaindnit	Oaidnit
Oainnan	Oainnán
Oamasvuona	Omasvuona
Oamasvuotna	Omasvuotna
Oanehaccat	Oanehaččat
Oanádusaŧ	Oanádusat
Oapahusoassi	Oahpahusoassi
Oapahusvirggit	Oahpahusvirggit
OarjeFinnmárkku	Oarje-Finnmárkku
OarjeFinnmárkkus	Oarje-Finnmárkkus
Oarjel	Oarjil
Oassálasttit	Oassálastit
Oddleig	Oddleif
Odontologisalaš	Odontologalaš
Odná	Odne
Oftund	Oftung
Ohcamistis	Ohcamisttis
Ohcejot`guoika	Ohcejotguoika
Okasašmearrádusaid	Oktasašmearrádusaid
Oktibuot	Oktiibuot
Oktiibuoŧ	Oktiibuot
Olenogorskkas	Olenogorskas
Olggešbellodaga	Olgešbellodaga
Olggešbellodat	Olgešbellodat
Olgggobealde	Olggobealde
Olgoritdirektoráhtas	Olgoriikadirektoráhtas
Olgoritministtar	Olgoriikaministtar
Oljorevrrat	Oljorevrret
Ollogat	Ollugat
Olluhat	Ollugat
Olmmaivággái	Olmmáivággái
Olmmaivákkis	Olmmáivákkis
Olmmáivággai	Olmmáivággái
Olmmáiváikkis	Olmmáivákkis
Olymppia	Olympia
Om.	Omd.
Omas-vuonas	Omasvuonas
Oppohatvihkái	Oppahatvihkái
Organisašuvdanstruktuvra	Organisašuvdnastruktuvra
Organiserenamálle	Organiserenmálle
Orušii	Orošii
Oskuoahpahussi	Oskuoahpahussii
Osllu	Oslo
Otna	Otne
Oudalasvarre	Ovddaldasvárri
Ouiti	Outi
Ounasjoga	Ovnnesjoga
OvB	OVB
Ovdaneami	Ovdáneami
Ovdaseattiin	Ovdaseahtain
Ovdda	Ovtta
Ovddadusbellodaga	Ovddádusbellodaga
Ovddadusbellodagain	Ovddádusbellodagain
Ovddadusbellodagas	Ovddádusbellodagas
Ovddadusbellodat	Ovddádusbellodat
Ovddádusbelodahkii	Ovddádusbellodahkii
Ovdeliš	Ovdalis
Ovttamanut	Ovttatmanu
Ovttaoaivilias	Ovttaoaivilis
Ozovuoigatvuoda	Ozovuoigatvuođa
Ođđá	Ođđa
P4:š	P4:s
Pakistáner	Pakistánar
Palto	Paltto
Parlameantaralaš	Parlamentáralaš
Parlameanttaralaš	Parlamentáralaš
Parlamentta	Parlameantta
Parlamenttaralaš	Parlamentáralaš
Parlamentarálaš	Parlamentáralaš
Personálstivrra	Personálastivrra
Perualaččat	Perulaččat
Petrozavodskis	Petrozavodskas
Pirtiijärvi	Pirttijärvi
Pirtijävri	Pirttijärvi
Pirttajärvi	Pirttijärvi
Poastaboksá	Poastaboksa
Poktasašvuohta	oktasašvuohta
Politija	Politiija
Politijat	Politiijat
Politiját	Politiijat
Politikalaš	Politihkalaš
Porche	Porsche
Porsánggu	Porsáŋggu
Porsánggus	Porsáŋggus
Porsángu	Porsáŋgu
Poršaŋggu	Porsáŋggu
Poršánggu	Porsáŋggu
Poršánggus	Porsáŋggus
Posáŋggus	Porsáŋggus
Praguaya	Paraguaya
Praktihkkalaš	Praktihkalaš
Prestbakkmo	Prestbakmo
Prinsippa	Prinsihpa
Privahta	Priváhta
Prixai	Prixii
Proavas	Proavás
Promillegilvvu	Promillagilvvu
Prošeakteruđaid	Prošeaktaruđaid
Prošeeaktaáigodagas	Prošeaktaáigodagas
Pršaŋgui	Porsáŋgui
Psykogeriatrijalaš	Psykogeriatriijalaš
Pulvvaraparahtaid	Pulvvarapparáhtaid
Pyskologa	Psykologa
Qaanaag:s	Qaanaaqas
Quvigag	Qavigaq
Rabdal	Randal
Rafi	Ráfi
Rahkadedje	Ráhkadedje
Raisavuotna	Ráisavuotna
Ranghild	Ragnhild
Ravotjohka	Rávotjohka
Raymon	Raymond
Reantut	Reanttut
Rehketdoalutallat	Rehketdoallologut
Ridus	Riđus
Rihttás	Rihtás
Riihmágálláin	Riihmagálláin
Rikkarevišuvnnas	Riikkarevišuvnnas
Ristamuornjággas	Ristamuornjárggas
Ristenráuna	Ristenrauna
Risttálaš	Risttalaš
Riđđu-festi-válas	Riddu-festiválas
Roavatjohka	Roavátjohka
Roavesávvonis	Roavesavvonis
Roavvesávvonis	Roavesavvonis
Roavvesávvonnis	Roavesavvonis
Roavvotjogas	Roavotjogas
Roađuin	Ruođuin
Romantihkkalaš	Romantihkalaš
Romsdálas	Romsdalas
Romssaas	Romssas
Romssii	Romsii
Romálaš	romalaš
Roung	Ruong
Ruhtašeakka	Ruhtašeahkka
Ruksesriebanaŧ	Ruksesriebanat
Rungu	Ruŋgu
Ruonaeanama	Ruonáeatnama
Ruovttubáikematkkošteaddjiid	Ruovttubáikemátkkošteddjiid
Ruovttusuodjaleddjit	Ruovttusuodjaleaddjit
Ruoŧ	Ruoŧa
Ruoŧas-Suomas	Ruoŧŧa-Suomas
Ruoŧta	Ruoŧŧa
Rustefielbma	Ruostefielbmá
Rustefielbmá	Ruostefielbmá
Rusttegiida	Rusttegiidda
Ruvvas	Ruvvaš
Ruškessáhpan	Ruškessáhpán
Ruŧtii	Ruŧŧii
Ráddehus	Ráđđehus
Rádjarasttildeamiin	Rádjarasttildemiin
Ráhkkistehpet	Ráhkistehpet
Ráissá	Ráissa
Ráissás	Ráissas
Ráissávuonas	Ráisavuonas
Ráisá	Ráisa
Ránaidsullo	Ránáidsullo
Ránddá	Ránda
Rápmefievrredeapmi	Rápmafievrredeapmi
Rástegáissa	Rástegáissá
Ráve-party	Raveparty
Rávisobmuidoahpahus	Rávisolbmuidoahpahus
Rávttošvuomigierra	Rávttošvuomegiera
Ráđđáhussii	Ráđđehussii
Ráŋggástuslága	Ráŋggáštuslága
SAFE:ai	SAFE:i
SGP:ai	SGP:i
SGPai	SGP:i
Saare	Saari
Sabassen	Sabbasen
Sahtá	Sáhttá
Sahtášii	Sáhtášii
Saint-Exupry	Saint-Exupéry
Saivvuopmi	Sáivvuopmi
Salášvággi	Sálašvággi
SamSamTak:a	SamTak
Samediggi	Sámediggi
Samedikki	Sámedikki
Samedikkis	Sámedikkis
Sameradio	Sámeradio
Sami	Sámi
Samiid	Sámiid
Samiradio	Sámiradio
Sammallahtti	Sammallahti
Sandbergga	Sandberga
Sara:i	Sarai
Sarggo	Sárggo
Sarrre	Sarre
Sarvesčielgi	Sarvvesčielgi
Satnejođiheaddji	Sátnejođiheaddji
Savä	Sevä
Scherfp	Scherpf
School:ii	Schoolii
Sd.dieđ	St.dieđ.
Seahkkevuona	Seahkkavuona
Seaidnu	Sieinnus
Seamm	Seamma
Seammas	Seammás
Seađašii	Seađášii
Seseana	Sesana
Setergamdalenis	Sætergamdalenis
Seurujärvikari	Seurujärvi-Kari
Shcnitler	Schnitler
She-fongá	Shefonga
Sibirjás	Sibirjjás
Sieida	Sieiddá
Sieiddajoga	Sieiddájoga
Sierrapedagogálaš	Sierrapedagogalaš
Sihkke	Sihke
Sihčajár	Sihčajávrri
Sijtei	Sijtii
Sirbma	Sirbmá
Sirbmás	Sirpmás
Sisilialáččat	Sisilialaččat
Skanit	Skánit
Skarfvággi	Skárfvággi
Skeanka	Skeaŋka
Skervvás	Skiervvás
Sketsmokorset	Skedsmokorset
Ski-doo	Ski-Doo
Skirvejávrris	Skirvvejávrris
Skervá	Skiervá
Skervás	Skiervvás
Skoghøi	Skoghøy
Skohtegeaidnu	Skohtergeaidnu
Skoválaččaŧ	Skoválaččat
Skuohtanjarga	Skuohtanjárga
Skuohttanjarga	Skuohttanjárga
Skuuterluodda	Skuterluodda
Skuvlagovatŧ	Skuvlagovat
Skáanit	Skánit
Skáni	Skániid
Skánis	Skániin
Sloahtas	Šloahtas
Sloahtta	Šloahtta
Smediggi	Sámediggi
Smedikki	Sámedikki
Smiehtaskasat	Smihtaskasat
Soabbada	Soabada
Soaittan	Soaittán
Soaiála	Sosiála
Soalddahat	Soalddáhat
Soapmasat	Soapmásat
Sobmy	Somby
Soffa	Soffá
Soffacuiggodeaddji	Soffácuiggodeaddji
Sohpparvadda	Sohpparvađđa
Soilbakk	Solbakk
Solbakken-Härkonen	Solbakken-Härkönen
Solbergga	Solberga
Solberggas	Solbergas
Sombu	Somby
Somby:ii	Sombyi
Sorjjakehtes	Sorjjaskeahtes
Sosialistalaš	Sosialisttalaš
Sosiálistalaš	Sosialisttalaš
Sosiálisttalaš	Sosialisttalaš
Spalloaivi	Spálloaivi
Spektrumas	Spektrumis
Spellemannprisena	Spellemannsprisena
Spiertagáissa	Spiertagáissá
Sportsskytter	Sportskytter
Spániijas	Spánias
SPÁNIJAS	SPÁNIAS
Spánijai	Spániai
Stahta	Stáhta
Stahtaráđis	Stáhtaráđis
Staskog	Statskog
Statoilo	Statoil
Statskogai	Statskogii
Statskogs	Statsskoga
Steinár	Steinar
Stockolmmas	Stockholmas
Stoltenbergga	Stoltenberga
Storadiggi	Stuorradiggi
Storeviika	Storevika
Stourajavrre	Stuorajávri
Strandebarm-vuostildeaddjit	Strandebarm-vuosttildeaddjit
Strandebarmma	Strandebarma
Strindberggas	Strindbergas
Strupesang	Čottalávlun
Studieinspektøra	Studieinspektevra
Stuoradigegválgii	Stuorradiggeválgii
Stuoradigge	Stuorradikke
Stuoradikkedieđahus	Stuorradiggedieđáhus
Stuorradikkedieđáhus	Stuorradiggedieđáhus
Stuorrarošujogas	Stuorrarošujogaš
Stuorádiggeáirras	Stuoradiggeáirras
Stádameahcce	Stádameahci
Stádavuovde	Stádavuovdi
Stáhtabušehta	Stáhtabušeahta
Stáhtá	Stáhta
Sunnje	Sutnje
Suodalusa	Suodjalusa
Suodjaluskommánddo	Suodjaluskommándo
Suoladit	Suoládit
Suolggujohka	Šuolggajohka
Suomá	Suoma
Suorgihahtti	Suorggahahtti
Suoššjávre	Šuoššjávri
Susannás	Susánnás
Suväjärvi	Syväjärvi
Sveicas	Šveicas
Sveičas	Šveicas
Sværde	Sverd
Syktyvkarska	Syktyvkara
Sáb	SáB
Sáhtan	Sáhtán
Sáhtat	Sáhtát
Sáhttan	Sáhtán
Sáhttibeahte	Sáhttibeahtti
Sáhtáná	Sáhtána
Sállevárre	Sállevárri
Sámdiggeráđđi	Sámediggeráđđi
Sámdiggi	Sámediggi
Sámedeggeválgga	Sámediggeválgga
Sámediggai	Sámediggái
Sámedigge	Sámedikke
Sámediggeráde	Sámediggeráđe
Sámediggerádi	Sámediggeráđi
Sámediigi	Sámediggi
Sámediki	Sámedikki
Sámedikkiráđi	Sámediggeráđi
Sámedikkiválggaid	Sámediggeválggaid
Sámeedikki	Sámedikki
Sámeguovllunjuolggadusaŧ	Sámeguovlonjuolggadusat
Sámekánale	sámekanála
Sámemanntálla	Sámemantálla
Sámemeastir	Sámemeasttir
Sámemeastirfinálas	Sámemeasttirfinálas
Sámemeaštir	Sámemeašttir
Sámevuoigatvuođatlávdegotti	Sámevuoigatvuođalávdegotti
Sámieatneln	Sámieatnan
Sámii	Sámiid
Sámu	Sámi
Sápmai	Sápmái
Sápmeláččat	Sápmelaččat
Sápmelččaid	Sápmelaččaid
Sápmiparkkas	Sápmiparkas
Sáráhka	Sáráhká
Sáráhkas	Sáráhkás
Sáráhkka	Sáráhkká
Sávcaboanddat	Sávzaboanddat
Sávžžus	Čávžžus
Sážža	Sážžá
Sážžás	Sáččás
Tamperees	Tamperes
Tapeis	Tapeias
Tapio:ii	Tapioi
Taxi	Tákse
Teáther	Teáhter
Teaterein	Teateriin
Tekhihkalas	Teknihkalaš
Telemedisinalaš	Telemedisiinnalaš
Teletorggas	Teletorgas
Tennesee	Tennessee
Thailandda	Thailanda
Thailanddas	Thailandas
Thommessen	Thommesen
Tihttal	Tihttel
Tingsret	Tingsrett
Tjell	Tjelle
Tornjørn	Torbjørn
Tradnoma	Tradenoma
Transejoik	Transjoik
Trimuf	Triumf
Tromssás	Tromssas
Trondinin	Trondimin
Tronheim	Trondheim
Trøndelágii	Trøndelagii
Turistain	Turisttain
UV:ai	UV:i
Uarctic	UArctic
Uhcastálos	Uhcastáloš
UiTØ	UiTø
Ulbil	Ulbmil
Unicoda-teknologiija	Unicode-teknologiija
Uniuvdna	Uniovdna
Uniuvdnii	Uniovdnii
Uniuvnna	Uniovnna
Univeristehta	Universitehta
Universetehtas	Universitehtas
Universietehtii	Universitehtii
Universitehtta	Universitehta
Universtehtas	Universitehtas
Univesitehta	Universitehta
Unjargga	Unjárgga
Unversitehtastivra	Universitehtastivra
Unviersitehtas	Universitehtas
Unárgga	Unjárgga
Urheilotalo	Urheilutalo
Urjö	Yrjö
Vahäpihä	Vanhapiha
Vaiko	vaikko
Vaillahan	Váillahan
Valdoragat	Váldoragat
Valkeapaa	Valkeapää
Valkeapæ	Valkeapää
Valkepää	Valkeapää
Válkeapãã	Valkeapää
Valkeapãã	Valkeapää
Valkiæpææ	Valkeapää
Valáštallanhallas	Valáštallanhállas
Vardobaiki	Várdobáiki
Vatnatjávri	Vatnimajávri
Vatnimjávri	Vatnimajávri
Vattenfestiválaš	Vattenfestivalenis
Veahaš	Veaháš
Veakehit	Veahkehit
Vearidida	Veardida
Vearroguitečálliŧ	Vearroguitečállit
Vedhuggnes	Vedhugnes
Vela	Velá
Velo	Veli
Vialjat	Vieljat
Viedokonferánsarusttegat	Videokonferánsarusttegat
Viesterális	Viestterálas
Vihkkedallamistis	Vihkkedallamisttis
Viidasit	Viidásit
Viiđát	Viđát
Vimmat	Viimmat
Vimme	Wimme
Virgai	Virgái
Virgáibidjámis	Virgáibidjamis
Vuigatvuođalávdegotti	Vuoigatvuođalávdegotti
Vuoccetvuopmi	Vuohcetvuopmi
Vuoddasvárri	Vuottašvárri
Vuogehii	Vuogihii
Vuoigatvuohtaministerjiijái	Vuoigatvuođaministeriijai
Vuoktačuohppahatfitnodat	Vuoktačuohpahatfitnodat
Vuolgasmasjohka	Vuolgamašjohka
Vuolle-Geavŋŋas	Vuolle-Geavŋŋis
Vuoofágalohkama	Vuođđofágalohkama
Vuorkadávvirat	Vuorká-Dávvirat
Vuorkkagovva	Vuorkkágovva
Vuorká-Dávvviriin	Vuorká-Dávviriin
Vuorkááššenr	Vuorkááššenr.
Vuostaš	Vuosttaš
Vuostebealiŧ	Vuostebealit
Vuosttažettin	Vuosttažettiin
Vuosttščájálmas	Vuosttaščájálmas
Vuovdaguikkas	Vuovdaguoikkas
Váhnenkeahttassearvvi	Váhnenkeahtessearvvi
Váhnenkeahttás	Váhnenkeahtes
Váhčiri	Váhčirii
Váibbihan	Váibbahan
Váiddakeahttá	Váiddekeahttá
Váillevaš	Váilevaš
Váilojit	Váilot
Vájas	Vajas
Válaštallan	Valáštallan
Válddan	Válddán
Váldojuolggadusat	Váldonjuolggadusat
Váldoáššálaccat	Váldoáššálaččat
Várggain	Várggáin
Várggat	Várggát
Várrá	Várra
Vástadus	Vástádus
Vátádusat	Vástádusat
Vázzálan	Vázzilan
Välkeapää	Valkeapää
Walesis	Walesas
Wenhce	Wenche
Wiler	Wilen
Yat-kha	Yat-Kha
Yle:ii	Ylei
Yle:s	Yles
Yorkis	Yorkas
Youngiin	Youngain
Youtube	YouTube
Zealanddas	Zealandas
Zealeanddas	Zealandas
Zell:ii	Zellii
aboneanttaide	abonneanttaide
abstrakta	abstrákta
abut	ábut
adaptašudvii	adaptašuvdnii
addan	addán
additiivaide	additiivvaide
adelmáilmmis	ádelmáilmmis
adjanivččii	ádjánivččii
adnimin	atnimin
adnojuvvoi	adnojuvvui
advokahtta	advokáhtta
agivuločiidda	agivuložiidda
agresiiva	aggressiiva
agrešuvdna	aggrešuvdna
ahe	ahte
ahkasaš	ahkásaš
ahkáhaš	ahkahaš
ahtii	áhtii
ahttalaš	ahttalas
aibbas	áibbas
aiddostahttiŧ	aiddostahttit
aidduhan	áidduhan
aidduhin	áidduhin
aidduhit	áidduhit
aidna	áidna
aigemearri	áigemearri
aigge	áigge
aiggi	áiggi
aiggis	áiggis
aiggo	áiggo
aiggun	áiggun
aigot	áigot
aigu	áigu
aigumen	áigumen
aigut	áigut
aitosaccat	aitosaččat
aj	ja
akademihkár	akademihkar
aktiivalaččat	aktiivvalaččat
aktivvalaččat	aktiivvalaččat
aktoealihaŧ	aktoealihat
aktoráđálaččaŧ	aktoráđálaččat
akšuvdadoaluin	akšuvdnadoaluin
akšuvdnavuggiid	akšuvdnavugiid
alaš	aláš
albm1ái	albmái
albmotlašbeaivi	álbmotlašbeaivi
albmáiolbmo	almmáiolbmo
alccasii	alccesis
alccedeamet	alcceseamet
alccesaset	alcceseaset
alccesii	alccesis
alces	alcces
alelassii	álelassii
alfabeahtalaš	alfabehtalaš
alga	álgá
alggahan	álggahan
algá	álgá
alimiiddádasadet	alimiiddáseattet
alimusrievttijustitiarus	alimusrievttijustitiarius
alki	álki
allagealddamásttaŧ	allagealddamásttat
allaskuvllafáláldat	allaskuvlafálaldat
allaskuvllaŧ	allaskuvllat
allaskuvlá	allaskuvla
alle	dalle
almmai	almmái
almmolaccat	almmolaččat
almmolas	almmolaš
almmuhuvui	almmuhuvvui
almmuhuvvet	almmuhuvvojit
almmuhuvvoi	almmuhuvvui
almmulaš	almmolaš
alo	álo
alvvalas	alvvalaš
amadadju	ámadadju
amadaju	ámadaju
amadajuid	ámadajuid
amadajut	ámadajut
amalgama	amalgáma
ambasadevra	ambassadevra
ambassadoran	ambassadevran
ambulansa	ambulánsa
amerihka	amerihká
amerihkalaš	amerihkálaš
amerihkkálaš	amerihkálaš
ammas	amas
ammatsuorgái	ámmátsuorgái
amoc	Amoc
amás	amas
analiseret	analyseret
anatomijalaš	anatomiijalaš
andagassii	ándagassii
anehahtti	anihahtti
anoniima	anonyma
anti-rasistalaš	antirasisttalaš
anáris	Anáris
apeallas	kapeallas
apparahta	apparáhta
apparahtta	apparáhtta
aprilmánu	áprilmánu
arbevirolaš	árbevirolaš
areaálii	areálii
arenáin	arenain
arenát	arenat
arkiivaide	arkiivvaide
arkitekta	arkiteakta
arktitektuvrras	arkitektuvrras
arrat	árrat
artihkala	artihkkala
artihkalis	artihkkalis
artihkalistis	artihkkalisttis
artihkkalistis	artihkkalisttis
artihkkel	artihkal
artistaid	artisttaid
arvvostallat	árvvoštallat
arvvoštallat	árvvoštallat
asahit	ásahit
asahuvvon	ásahuvvon
asahuvvot	ásahuvvot
aspirantan	aspirántan
assadeabbo	gasit
assiid	ássiid
asttoáigge	astoáigge
at	ahte
atlása	átlasa
atnan	atnán
atnobiktasiid	atnubiktasiid
atnojit	adnojit
attaldagat	attáldagat
avdnasiid	ávdnasiid
aviisaid	aviissaid
aviisaide	aviissaide
aviisain	aviissain
avisii	áviisii
avjodinga	ávjodiŋga
avviissa	aviissa
avvudeami	ávvudeami
avžžuhat	ávžžuhat
ađaide	áđaide
aŋgiris	áŋgiris
aŋke	aŋkke
ašši	ášši
aššit	áššit
badjana	badjána
badjanan	badjánan
badjelas	badjelaš
badjelbáza	badjebáza
badjebázahaga	badjebáhcaga
badjelluotta	badjeluotta
badjelmearálaccat	badjelmearálaččat
badjelš	badjelaš
badjeolbuid	badjeolbmuid
badjerádjemeariŧ	badjerádjemearit
badjigit	badjugit
badjilmearalaccat	badjelmearálaččat
badjilmeare	badjelmeare
baessá	beassá
baha	bahá
bahabihkkán	bahánihkkán
bahabut	bahábut
bahanihkkán	bahánihkkán
bahcá	báhcá
bahkkaseamos	báhkkaseamos
bahánihkkanat	baháneahkkánat
bahánihkánis	bahánihkkánis
baiccá	baicca
baikkiin	báikkiin
baikkáhalla	baikkahallá
bajabealde	bajábealde
bajas	bajás
bajasgeassimii	bajásgeassimii
bajasgeassimiidda	bajásgeassimiidda
bajasgeassimis	bajásgeassimis
bajasgeassin	bajásgeassin
bajasgesson	bajásgesson
bajasšaddan	bajásšaddan
bajemus	bajimus
bajemusas	bajimusas
bajemussii	bajimussii
bajimusasa	bajimusas
bajánas	bajánaš
bajásčuožželeami	bajásčuožžileami
bakteriaid	bakteriijaid
bakteriat	bakteriijat
bakčasat	bákčasat
balddahallat	balddáhallat
balddalagaid	bálddalagaid
balddas	bálddas
balla	ballá
balleahta	baleahta
ballestalai	ballástalai
ballestallat	ballástallat
balljo	bálljo
balluid	bálluid
balvalusaid	bálvalusaid
balá	bala
balánseret	balanseret
banana	banána
bandain	bánddain
baniiguin	bániiguin
bara	bára
bardni	bárdni
barga	bargá
barggaši	barggašii
barggiid	bargiid
barggiidde	bargiide
barggiide	bargiide
barggit	bargit
barggudet	barggodet
bargguidda	bargguide
bargguigun	bargguiguin
barggá	bargga
bargiguin	bargiiguin
bargiibellodat	bargiidbellodat
bargiidde	bargiide
bargodiili	bargodili
bargoduođaštusmáŋggehusaiguin	bargoduođaštusmáŋgehusaiguin
bargohárjaneami	bargohárjáneami
bargohárjaneapmi	bargohárjáneapmi
bargomátkiid	bargomátkkiid
bargomátkiin	bargomátkkiin
bargoskihpariin	bargoskihpáriin
bargoskihppáriid	bargoskihpáriid
bargoáhki	bargoahki
barguid	bargguid
barguimahccamii	barguimáhccamii
bargujoavku	bargojoavku
bargujuvvui	bargojuvvui
bargánis	barggánis
bartideimme	bártideimme
baseaŋgaide	basseaŋggaide
bassebeavi	bassebeaivi
basádit	basadit
batnedivššarbálvalusas	bátnedivššárbálvalusas
bc	bc.
bdii	bođii
beaggan	beaggán
beahtala	biehttala
beaivai	beaivái
beaive	beaivi
beaivegirjjii	beaivegirjji
beaivvaduvvon	beaiváduvvon
beaivvalaččat	beaivválaččat
beaivvalaš	beaivválaš
beaivves	beaivvis
beaivviid	beivviid
beaivváduvvon	beaiváduvvon
beaiváš	beaivváš
beaivášis	beaivásis
beakkan	beakkán
beakkanis	beakkánis
beakkáneammos	beakkáneamos
beakt	beaktu
bealakeahtes	bealátkeahtes
bealalaš	bealálaš
bealatlaš	bealálaš
bealdi	bealde
bealgoalmmat	bealgoalmmát
bealjjehis	bealjehis
bealjái	bealljái
bealladagas	bealládagas
beallefinálai	beallefinálii
beallemuttos	beallemuttus
beallesuroheamit	beallesuruheamit
bealljebuncciid	bealljebunciid
bealljeheamit	bealjeheamit
bealáhat	bealágat
bearašsoadjalusa	bearašsuodjalusa
bearaščájálmaš	bearaščájálmas
bearjadag	bearjadaga
bearjaga	bearjadaga
bearoškeahttá	beroškeahttá
bearraigeahču	bearráigeahču
bearraigeahčču	bearráigeahčču
bearraŧ	bearrat
bearražis	bearrašis
bearre	beare
bearráigeahččuin	bearráigeahčuin
bearráigehčuin	bearráigeahčuin
bearráša	bearraša
bearrášiid	bearrašiid
bearrášiidda	bearrašiidda
bearrášiin	bearrašiin
bearáš	bearaš
bearášterapeuta	bearašterapevta
beassa	beassá
beassaimet	beasaimet
beassašbeaivi	beassášbeaivi
beassašbeaivvi	beassášbeaivvi
beassažiid	beassážiid
beastasit	beastásit
beastiŧ	beastit
beasái	beasai
beasán	beasan
beatnagiigui	beatnagiiguin
beavde	beavdi
beavdegeahčai	beavdegeahčái
beavdegirjjid	beavdegirjjiid
beavttalmahttit	beavttálmahttit
beaškkala	beaškala
behttala	biehttala
behttalit	biehttalit
beiviid	beivviid
beivvi	beaivvi
beladduide	bealdduide
bensigávppiin	bensingávppiin
berosmeahtton	berosmeahttun
berošdupmi	beroštupmi
berošgeahtta	beroškeahttá
beroškeahtta	beroškeahttá
beroštisgoahtit	beroštišgoahtit
beroštumii	beroštupmái
berošumiid	beroštumiid
berreivčče	berrešedje
berreli	berrelii
berresivčče	berrešedje
berrešivčče	berrešedje
berrešivččii	berrešii
berrešivččiigo	berrešiigo
berrrešivččiigo	berrešiigo
bessat	beassat
bevlamáđiijaid	bievlamáđijaid
biddj	biddjo
biddjat	bidjat
biddjujedje	biddjojedje
bidja	bidjá
bidjojuvvoje	biddjojuvvoje
bidján	bidjan
bidját	bidjat
biebmantáiggit	biebmanáiggit
biebmo	biebmu
biebmoabu	biebmoábu
biebmon	biebmun
biebmubearráigeahčču	biebmobearráigeahčču
biebmuid	biepmuid
biehkulas	bihkolas
biehmun	biebmun
biehtala	biehttala
biehtalkeahteš	biehtalkeahtes
bieksuid	bievssuid
bieksut	bievssut
biellabeasi	giellabeasi
biepmon	biebmun
bierget	birget
bierggasat	biergasat
bierggastiŧ	bierggastit
biergobuhttadeaddjin	biergobuvttadeaddjin
bifila	bifiila
bihta	bihtá
bihtain	bihtáin
bihtas	bihtás
bihtta	bihttá
bihttáin	bihtáin
biilaboahkana	biilaboahkána
biilaladnja	biilalatnja
biilavuodjit	biilavuoddjit
biillla	biilla
biilluodda	biilaluodda
bijái	bijai
biktasiigguin	biktasiiguin
biktasit	biktasiid
biktásiid	biktasiid
bilagii	bilágai
bilikeahttá	bilitkeahttá
biljarda	biljárda
billahuvva	billahuvvá
binna	binná
biologijjii	biologiijii
bira	birra
birasgahttendepartementii	birasgáhttendepartementii
birasgahttenhoavdda	birasgáhttenhoavdda
birasgahttenministar	birasgáhttenministtar
birasgahttenossodat	birasgáhttenossodat
birasgealbofierpmádaŧ	birasgealbofierpmádat
birasgáhttenkampanja	birasgáhttenkampánja
biraspoltihka	biraspolitihka
birgelági	birgenlági
birgenlagis	birgenlágis
birrasistis	birrasisttis
birrra	birra
birrá	birra
birut	birot
bisan	bisán
bisanan	bisánan
bisanansadji	bisánansadji
bisanasten	bisánastán
bisanastten	bisánastán
bisanii	bisánii
bisanit	bisánit
biseha	bisseha
bisjosiidda	bidjosiidda
bismasgotteráđi	bismagotteráđi
bispabihaheami	bispavihaheami
bissevaš	bistevaš
bissevašvuođa	bistevašvuođa
bissárahttimen	bissáráhttimen
bistii	bisttii
bisttáhallaŧ	bisttáhallat
bisániii	bisánii
bisáná	bisána
bivdan	bivdán
bivdigoahtet	bivdigohtet
bivdimiš	bivdimis
bivdoskihpar	bivdoskihpár
bivdoskihparat	bivdoskihpárat
bivdoskihppáris	bivdoskihpáris
bivdovuoigatvuoda	bivdovuoigatvuođa
bivttasdiŋggáid	bivttasdiŋggaid
bivud	bivdu
bivva	bivvá
bivástathájain	bivastathájain
bivástatrávssáid	bivastatrávssáid
blađđi	bláđđi
boa-res	boares
boahkana	boahkána
boahta	boahtá
boahtan	boahtán
boahte	boahtte
boahtegohte	boahtigohte
boahtemin	boahtimin
boahtet	bohtet
boahtetáiggis	boahtteáiggis
boahtevaš	boahttevaš
boahteáigge	boahtteáigge
boahteáiggi	boahtteáiggi
boahteáiggis	boahtteáiggis
boahteáigái	boahtteáigái
boahti	boahtti
boahtste	boahtte
boahtteváš	boahttevaš
boahtteáigges	boahtteáiggis
boaittobealođastusaŧ	boaittobealođastusat
boareš	boares
boarrasamos	boarrásamos
boarraseabbo	boarráseabbo
boarraseabbu	boarráseabbo
boarraseammos	boarráseamos
boarraseamos	boarráseamos
boarraseappot	boarráseappot
boarrasepmosii	boarrásepmosii
boarrasepmosis	boarrásepmosis
boarraset	boarráset
boarrasiid	boarrásiid
boarrasit	boarrásit
boarrasut	boarrásut
boarráseamosat	boarrásepmosat
boarrásot	boarrásut
boarásnun	boarásnuvvon
boastaboksái	boastaboksii
boastakántuvrrii	boastakantuvrii
boastogiroboandan	boastagiroboandan
boasttogáldduid	boasttogálduid
boasttut	boastut
boatkkakeahttá	boatkkukeahttá
boazo	boazu
boazobibmin	boazobibmiin
boazodaolu	boazodoalu
boazodoallo	boazodoallu
boazodoalloadvokahtta	boazodoalloadvokáhtta
boazodoallojovkku	boazodoallojoavkku
boazodoallui	boazodollui
boazodutkkit	boazodutkit
boazoeaiggat	boazoeaiggát
boazoeatnatvuodain	boazoeatnatvuođain
boazoedoallokántuvra	boazodoallokantuvra
boazoguođohanvuoigavuohta	guođohanvuoigatvuohta
boazoguvlluin	boazoguovlluin
boazoi	bohccui
boazonjuovaháhkii	boazonjuovahahkii
boazonjuováhaga	boazonjuovahaga
boazoÂ­doalliid	boazodolliid
boazočalát	boazoealát
boazudoalliid	boazodolliid
boazudoallu	boazodoallu
boazudoalu	boazodoalu
boazudoalus	boazodoalus
boazudollui	boazodollui
boađašedje	boađášedje
boađašii	boađášii
boađe-boađi	boađi-boađi
boađusárvvoštallamisastis	boađusárvvoštallamisttis
bodii	bođii
bodnejietnja	bodnejiekŋa
bohccobiergo	bohccobiergu
bohccoid	bohccuid
bohccu	bohcco
bohcida	bohciida
bohcidahttit	bohciidahttit
bohcidahttá	bohciidahttá
bohcidahttán	bohciidahttán
bohcidan	bohciidan
bohcidin	bohciidin
bohcidit	bohciidit
bohcit	bohčit
bohco	bohcco
bohcot	bohccot
bohctiidahtán	bohciidahtán
bohcuid	bohccuid
bohcuiguin	bohccuiguin
bohtusat	bohtosat
bohtál	bohtal
bohčimussan	bohčimuššan
bohččigohtet	bohčigohtet
bohččima	bohčima
bohččuiguin	bohccuiguin
bonjjai	bonjai
bonket	boŋket
boradettin	boradettiin
boraspiirid	boraspiriid
boregmánu	borgemánu
borggukeahtes	borggutkeahtes
borggukeahttá	borggutkeahttá
borjjástan	borjjastan
borramusa	borramuša
borrádit	boradit
borrášiidjoavkkut	boarrásiidjoavkkut
borssodit	borššodit
borsu	boršu
boráspiire	boraspire
bosada	bosáda
botkkii	botkii
botnjuguvlui	bonjuguvlui
botnái	bodnái
bovdahallon	bovdehallan
bođohat	buđohat
bođu	buođu
brošjyrain	brošyrain
bucciiddikšu	buhcciiddikšu
budšeahta	bušeahta
buers	bures
buhccide	buhcciide
buhtadankeahttá	buhtatkeahttá
buhttadeami	buhtadeami
buhttadeapmi	buhtadeapmi
buhtádusa	buhtadusa
bukta	buktá
buktan	buktán
buktejun	buktojuvvon
buktojuvo	buktojuvvo
bulgáralaš	bulgárialaš
bullejit	bullehit
bulvi	bulvii
bumbba	bumbbá
buoddun	buođđun
buodu	buođu
buoemus	buoremus
buogustahttá	boagustahttá
buohccuvuođa	buohcuvuođa
buohciviesus	buohcciviesus
buohiad	buohkaid
buohkaidda	buohkaide
buohtalága	buohtalaga
buohtastahttejit	buohtastahttet
buohtastáhtten	buohtastahtten
buohtastáhttit	buohtastahttit
buohtastáhtán	buohtastahtán
buohstahtti	buohtastahtti
buollai	buollái
buolliima	buollima
buorastahtte	buorástahtte
buorašit	buorášit
buorideamiŧ	buorideamit
buorimus	buoremus
buorrana	buorrána
buorranivččii	buorránivččii
buorremus	buoremus
buotbeallášaččaid	buotbeallásaččaid
buremielas	buoremielas
buresboahttima	buresboahtima
buresivdnidii	buressivdnidii
burgan	burgán
burjahtalaččat	burjáhtialaččat
busttávat	bustávat
butkit	buktit
buđeaita	buđeita
buđđošuvvame	buđđosuvvame
bušeaha	bušeahta
bušehta	bušeahta
bušehtas	bušeahtas
bušehtii	bušehttii
bvuoruhan	vuoruhan
byråkratiai	byråkratiijai
bábirlatna	bábirlátna
báci	bázii
bádjel	badjel
bádnimii	báidnimii
bádnimiidda	báidnimiidda
bágadeamit	bagadeamit
bágadus	bagadus
bággobargogeatnegasaŧ	bággobargogeatnegasat
bággolonistanláhkavuodu	bággolonistanláhkavuođu
bággolonistanvuoduŧ	bággolonistanvuođut
báhkkada	báhkada
báhkkodeamiin	báhkkodemiin
báhper	bábir
báhpá	báhpa
báhtii	báhttii
báhtárit	báhtarit
báhá	bahá
báhábut	bahábut
báháid	baháid
báhča	báhčá
báhčimiš	báhčimis
báhčinšilljuid	báhčinšiljuid
báicca	baicca
báicce	baicce
báicco	baicca
báikai	báikái
báikalaš	báikkálaš
báikaráigái	baikaráigái
báikeovdáneamii	báikeovdáneami
báikiin	báikkiin
báikkaid	baikkaid
báikkat	baikkat
báikkii	báikkiid
báikklaš	báikkálaš
báikkohagaide	báikkohagaid
báikkálaccat	báikkálaččat
báikkáláš	báikkálaš
báisttu	báistte
bájilčálá	bajilčála
bájimus	bajimus
bájimuš	bajimuš
báktefágalaccat	báktefágalaččat
báktevuoigatvuodaid	báktevuoigatvuođaid
báktevuoigatvuodaide	báktevuoigatvuođaide
báktevuoigatvuodat	báktevuoigatvuođat
bálddalágaid	bálddalagaid
bálddasteahttit	bálddastahttit
bálddastáhttá	bálddastahttá
bálddonas	balddonas
báldi	baldi
bálgaide	bálgáide
báljjo	báljo
bálkašumi	bálkkašumi
bálkašupmi	bálkkašupmi
bálkka	bálkká
bálkkášat	bálkkašat
bálkkášumi	bálkkašumi
bálkkášupmi	bálkkašupmi
bálkáraidalas	bálkáráidalas
bálkášumi	bálkkašumi
bálkášupmi	bálkkašupmi
bálus	balus
bálvaide	bálvváide
bálvaleddji	bálvaleaddji
bálvaluat	bálvalusat
bárdnilaš	bárdnelaš
bárdnášis	bárdnásis
bárgiidbellodat	bargiidbellodat
bárgiiguin	bargiiguin
bárgoárjjaide	bargoárjjaide
bárrástávval	bárrastávval
bárta	barta
bártidideamis	bártideamis
bártnime	bárdnáme
bártta	bartta
bárttaid	barttaid
bárttnit	bártnit
bátnedoavtir	bátnedoavttir
bátnegáskkii	bátnegáskki
bátnázis	bártnážis
bávalusaid	bálvalusaid
cabares	cabaréas
cabmet	cábmet
cada	čađa
cakcat	čakčat
campinbiillat	campingbiillat
cand.scient	cand.scient.
caská	časká
cavga	čavga
cavgileamiid	cavgilemiid
ceahkkuhit	ceakkuhit
cealka	cealkka
cealkamuš	cealkámuš
cealkamuša	cealkámuša
cealkkekeahteš	cealkkekeahtes
cealkká	cealká
cearddalaccat	čearddalaččat
ceavcilis	ceavzilis
ceavrá	čeavrá
ceavvedalvvi	ceavvedálvvi
ceggedje	ceggejedje
cehkkiid	cehkiid
celkii	celkkii
celkkojuvvo	celkojuvvo
celkojuvvoi	celkojuvvui
celkosiida	celkosiidda
celká	cealká
centi	sentte
cicážiid	cizážiid
cieggadiŧ	cieggadit
ciekŋalat	čiekŋalat
cielga	čielga
cielggadit	čielggadit
cilget	čilget
circumpolara	cirkumpolára
cirkumpolara	cirkumpolára
ciŋaid	čiŋaid
coaganaŧ	coaganat
coakkánáigi	čoakkánáigi
cohkodaŧ	cohkodat
cujuha	čujuha
cujuheami	čujuheami
cujuhit	čujuhit
cuksasiidda	cukcasiidda
cuoggá	čuoggá
cuoggás	čuoggás
cuohcá	čuohcá
cuoiggodit	cuiggodit
cuojahit	čuojahit
cuonju	cuoŋu
cuonjuda	cuoŋuda
cuovkkasin	cuovkkas
cuovvovacca	čuovvovačča
cuovvovaš	čuovvovaš
cup:a	cupa
cup:s	cupas
cupai	cupii
cáhcecoahkuŧ	čáhcečoahkut
cáhcejodu	čáhcejođu
cáhci	čáhci
cájehan	čájehan
cájehit	čájehit
cálalaccat	čálalaččat
cállon	čállon
cávgileame	cavgileame
cázádatvuoigatvuodaid	čázádatvuoigatvuođaid
cázádatvuoigatvuodain	čázádatvuoigatvuođain
dab	dat
dadistaga	dađistaga
dadja	dadjá
dadja:	dadjá:
dadján	dadjan
dadját	dadjat
dafus	dáfus
dagatit	dagahit
daggár	dakkár
dagáhii	dagahii
dahka	dahká
dahkadusas	dáhkádusas
dahkidit	dáhkidit
dahkiduvvon	dáhkiduvvon
dahkkan	dahkan
dahkkat	dahkat
dahkkojovvošii	dahkkojuvvošii
dahkkojuvvun	dahkkojuvvon
dahkkun	dahkkon
dahkká	dahká
dahkogiettis	dahkugiettis
dahkán	dahkan
dahpagat	dáhpagat
dahpi	dáhpi
dahtto	dáhtto
dahttot	dáhttot
dahttu	dáhttu
daidde	dáidde
daidá	dáidá
daihe	dahje
dainná	dáinna
dajaahussii	dajahussii
dajdá	dadjá
dakkr	dakkár
dala	dalá
dallet	dalle
dallán	dalán
dalveborranbohccuin	dálveborranbohccuin
dalvesujiid	dálvesujiid
dalvvi	dálvvi
dappe	dáppe
darbbaš	dárbbaš
darbbašit	dárbbašit
darbbuid	dárbbuid
darbu	dárbu
darvana	darvána
darvanan	darvánan
darvanedje	darvánedje
darvanii	darvánii
darvanit	darvánit
darváneaddjil	darváneaddji
darváná	darvána
dassa	dassá
dassago	dasságo
dassai	dassái
dassažii	dassážii
dassožii	dassážii
dast	das
dastanaga	dasttánaga
dastto	dasto
dasá	dasa
databasa	databása
datl	dat
datnjasiid	dakŋasiid
davabealde	davábealde
davas	davás
davja	dávjá
davvás	davás
davve	davvi
davveleabbui	davvelebbui
davveoarje	davveoarji
davvi-tromssalaččain	davviromsalaččain
davviameriikká	Davvi-Amerihká
davvilas	davvilaš
davvimus	davimus
davvinuorttádahkan	davvinuorttadahkan
davábeal	davábealde
dađisdaga	dađistaga
daža	dáža
deaddan	deattán
deaddiluvvoi	deaddiluvvui
deahalaš	deaŧalaš
deahkkegeasahagat	deahkkegeasáhagat
deahttuhii	deattuhii
deahttuhuvvojit	deattuhuvvojit
deahálaš	dehálaš
deaivai	deaivvai
deaivasa	deaivása
deaivvad	deaivva
deaivvadeamiiguin	deaivvademiiguin
deaivvadi	deaivvadii
deaivvida	deaivida
deaivvidit	deaividit
dearvvasvuoda	dearvvašvuođa
dearvvasvuoda-	dearvvasvuođa-
dearvvasvuodadutkama	dearvvašvuođadutkama
dearvvašnuvvvat	dearvvašnuvvat
dearvvašvuođadirektorahta	dearvvašvuođadirektoráhta
deattuhuvo	deattuhuvvo
deattuhuvui	deattuhuvvui
deavda	deavdá
deađalaš	dieđalaš
deaŧalas	deaŧalaš
deaŧáleamoš	deaŧaleamos
dehálaccat	dehálaččat
dehálas	dehálaš
deháleammos	deháleamos
deháleamoš	deháleamos
dekar	dekára
dekara	dekára
delegata	delegáhta
demokrahtalaš	demokráhtalaš
demokratiijja	demokratiija
departementa	departemeanta
departementai	departementii
depertementta	departemeantta
deperttemeantta	departemeantta
detaljjaid	detáljjaid
deŧalaš	deaŧalaš
deŧaleabbo	deháleabbo
deŧaleabbon	deháleabbon
diagnusaide	diagnosaide
diagnusii	diagnosii
dialiisaide	dialiissaide
didjide	didjiide
died	dieid
diede	dieđe
diediha	dieđiha
diedihangeatnegasaŧ	dieđihangeatnegasat
dieduid	dieđuid
diedusge	dieđusge
diedut	dieđut
diedán	dieđán
dieh-tit	diehtit
dieht	diehtu
diehta	diehtá
diehtagiiddda	diehtagiidda
diehtan	diehtán
diehtelasaid	diehttelasaid
diehtelasat	diehttelasat
diehtetmeahttumat	diehtemeahttumat
diehtetmeahttunvuohta	diehtemeahttunvuohta
diehtetmeahttunvuođa	diehtemeahttunvuođa
diehtetmeahttuvuođa	diehtemeahttunvuođa
diehti	diehtit
diehto	diehtu
diehtocáluš	diehtočálus
diehttelaš	diehttelas
diehttemassii	diehttevassii
diehttávassii	diehttavassii
diekkar	diekkár
diekákr	diekkár
dienna	dieinna
dieut	dieđut
dievasčpahkkimis	dievasčoahkkimis
dievasđoahkkimiin	dievasčoahkkimiin
dievaščoahkkin	dievasčoahkkin
dievdo	dievdu
dievdolbmo	dievdoolbmo
dievdolbmos	dievdoolbmos
dievdolbmot	dievdoolbmot
dievdolbmuid	dievdoolbmuid
dievdolbmuide	dievdoolbmuide
dievdolbmuin	dievdoolbmuin
dievdolmmoš	dievdoolmmoš
dievdoolbmid	dievdoolbmuid
dievusge	dieđusge
dievái	dievai
dieđahus	dieđáhus
dieđat	dieđát
dieđeš	diđeš
dieđia	dieđiha
dieđiheapmai	dieđiheapmái
dieđihuvui	dieđihuvvui
dieđihuvvvui	dieđihuvvui
dieđos	dieđus
dieđosge	dieđusge
dieđáhusssii	dieđáhussii
dieđálaš	dieđalaš
dieđálašvuođa	dieđalašvuođa
diešusge	dieđusge
diftonga	diftoŋga
diggaid	diŋggaid
diggut	diggot
digitala	digitála
digástallat	digaštallat
digástallá	digaštallá
dihtomielalaččaŧ	dihtomielalaččat
dihtosupmái	dihttosupmái
dihtte	dihte
diibma	diibmá
diibmabeali	diibmobeali
diibmáš	diimmáš
diidjiide	didjiide
diihte	dihte
diihten	dihten
diihtet	dihtet
diimma	diimmá
diimmás	diimmáš
diine	dine
diinejit	dinejit
diinen	dinen
diinet	dinet
diinešeaigga	dinešeigga
dikkiš	dikkis
diktatora	diktáhtora
dikšunrusttegiida	dikšunrusttegiidda
dilalašvuohta	dilálašvuohta
dilalašvuođa	dilálašvuođa
dilalašvuođaid	dilálašvuođaid
dilalášvuođaide	dilálašvuođaide
dilidet	diliidet
dilálašvuodaid	dilálašvuođaid
dilálášvuođaid	dilálašvuođaid
dilálášvuođain	dilálašvuođain
dilálášvuođas	dilálašvuođas
dimmá	diimmá
dingga	diŋgga
dinggaid	diŋggaid
dinosaurat	dinosávrrat
direkteuvra	direktevra
direktevre	direktevra
direktevrre	direktevrra
direktuvra	direktevra
diskutehkas	diskotehkas
dist.	dis
ditnjan	dikŋan
divddán	divttán
divisuvdnii	divišuvdnii
divisuvnnas	divišuvnnas
divrriguin	divrriiguin
divudusa	divodusa
divudusaid	divodusaid
divudusain	divodusain
divudusat	divodusat
divudussii	divodussii
divuduvvojedje	divoduvvojedje
divuduvvon	divoduvvon
divutit	divuhit
divšuvdna	divišuvdna
divššohát	divššohat
diŋgojuvui	diŋgojuvvui
diŋgut	diŋgot
diškuhit	diškkuhit
doabmavugiin	doaibmavugiin
doahttalkeahtesvuođaŧ	doahttalkeahtesvuođat
doaibmabiddjo-eavttuhussii	doaibmabidjoevttohussii
doaibmabiddjoguovllu	doaibmabidjoguovllu
doaibmabidjuevttohusaid	doaibmabidjoevttohusaid
doaibmabidjuin	doaibmabijuin
doaibmabijjuin	doaibmabijuin
doaibmabohtusat	doaibmabohtosat
doaibmabohtusiid	doaibmabohtosiid
doaibmaekonomalaččaŧ	doaibmaekonomalaččat
doaibmaguovlustis	doaibmaguovllustis
doaibmapláná	doaibmaplána
doaibmasisabohtosiin	doaibmasisaboađuin
doaibmaprofilaid	doaibmaprofiillaid
doaimmadeaset	doaimmaideaset
doaimmaiseaset	doaimmaideaset
doaimmahusalaš	doaimmahuslaš
doaimmashehttejunpenšunisttat	doaimmashehttejuvvonpenšunisttat
doaimmeheaddji	doaimmaheaddji
doaimmeheddjin	doaimmaheddjiin
doaivo	doivo
doaivvoheamit	doaivvuheamit
doaivvon	doaivvun
doaivvušii	doivvošii
doaktaris	doaktáris
doakára	doaktára
doalahiŧ	doalahit
doalla	doallá
doalloovttodaga	doalloovttadaga
doalvvuid	doalvvui
doaláha	doalaha
doamat-doama	doama-doama
doangasat	doaŋgasat
doanggas	doaŋggas
doarjan	doarjjan
doarjaohcama	doarjjaohcama
doarjjošii	dorjjošii
doarján	doarjjan
doarvai	doarvái
doarvet	doarvái
doarvvái	doarvái
doavttaid	dovttaid
doavtter	doavttir
doavttergrada	doavttergráda
doavttergrádastipeandiáhtta	doavttergrádastipendiáhtta
doaškkaid	doaškkáid
dohkalaččaide	dohkálaččaide
dohkalaččat	dohkálaččat
dohkalaš	dohkálaš
dohkalašvuođa	dohkálašvuođa
dohkalažžan	dohkálažžan
dohkalažžii	dohkálažžii
dohke	dohkke
dohkehan	dohkkehan
dohkeheamis	dohkkeheamis
dohkeheapmi	dohkkeheapmi
dohkeheapmin	dohkkeheapmin
dohkehit	dohkkehit
dohkehuvvon	dohkkehuvvon
dohkeo	dohko
dohket	dohkket
dohkka	dohkká
dohkkalaččat	dohkálaččat
dohkkalaš	dohkálaš
dohkkehuvo	dohkkehuvvo
dohkkehuvvonš	dohkkehuvvon
dohkkenit	dohkkehit
dohkkálačča	dohkálačča
dohkkálaččat	dohkálaččat
dohkkálaš	dohkálaš
dohkkáš	dohkáš
dohkálaccat	dohkálaččat
dohpagiidda	doahpagiidda
dohpii	dohppii
doibmabadji	doaibmabadji
doimmaheaddji	doaimmaheaddji
doimmiide	doibmiide
dolastalladettiin	dolastaladettiin
dolaštisgohtet	dolastišgohtet
dollaspáiddara	dollaspáidara
dollačaskadeaddjit	dollačáskadeaddjit
dollojuvvoi	dollojuvvui
dorrvoheapme	dorvvuheapme
dorui	dorvui
dorvasin	dorvvastin
dorvo	dorvu
dorvvástit	dorvvastit
dorvásit	dorvvastit
dosamtriijaide	dosametriijaide
doudji	duodji
dovdaŧ	dovdat
dovddidit	dovddiidit
dovddidusaid	dovddiidusaid
dovddit	dovddat
dovddosin	dovddusin
dovdduseamos	dovdoseamos
dovdduš	dovddus
dovvdat	dovdat
dppe	dáppe
drbbuid	dárbbuid
driftsenhetain	doaluin
drkun	dárkun
drámahtalaččat	dramáhtalaččat
drámahtalaš	dramáhtalaš
drámatihkka	dramatihkka
drámáhtalaš	dramáhtalaš
dudjon	duddjon
dudnje	dutnje
duhat	duhát
duhkkáid	duhkáid
duhkorasvovda	duhkorasvovdna
duhpaha	duhpáha
duhpatvahátráđđi	duhpátvahátráđđi
duhtameahttunis	duhtameahttumis
duhttadit	duhtadit
duhttameahttumis	duhtameahttumis
duhttavaččat	duhtavaččat
duhttavaš	duhtavaš
dukasiidda	duskasiidda
duktamiid	dutkamiid
duljjiin	duljiin
dulkojuvvut	dulkojuvvot
dulvegeahpedanrustteŧ	dulvegeahpidanrusttet
dunnje	dutnje
duodaid	duođaid
duodje	duodji
duodnjan	duogŋan
duodnjasat	duogŋasat
duogaš	duogáš
duogaža	duogáža
duogábeal	duogábeal
duohpaga	doahpaga
duohtandagakeahteš	duohtandagakeahtes
duohtandáhkat	duohtandahkat
duoiđi	duođi
duokkariin	duokkáriin
duoljji	duolji
duoljjit	duoljit
duolvačáhce	duolvačáhci
duopmogirjjid	duopmogirjjiid
duopmustuollu	duopmostuollu
duoppar	doappar
duoras-tagas	duorastagas
duorasdaga	duorastaga
duosta	duostta
duosttilis	duostilis
duosttá	duostá
duosttás	duosttáš
duotŋaimet	duokŋaimet
duođa-štallamiidda	duođaštallamiidda
duođabit	duođabut
duođastusastis	duođaštusastis
duođaštiŧ	duođaštit
duođaštuš	duođaštus
duođis	duođas
duođá-štallamiidda	duođaštallamiidda
duođálažžan	duođalažžan
duođáštit	duođaštit
duođáštusávdnasaŧ	duođaštusávdnasat
dupmehallon	dubmehallon
dupmejit	dubmejit
dupmejuvvon	dubmejuvvon
dupmen	dubmen
dupmet	dubmet
duppalmorala	duppalmorála
duppál	duppal
duppálastit	duppalastit
duppáliid	duppaliid
duppáloaiviliid	duppaloaiviliid
duppáloaivilvuohta	duppaloaivilvuohta
duskkái	duskái
dutakmiid	dutkamiid
duthavaš	duhtavaš
dutje	dutnje
dutkamistis	dutkamisttis
dutkamus	dutkamuš
dutkanprofilas	dutkanprofiillas
dutkanrievttiš	dutkanrievttis
dutkansurggide	dutkansurggiide
dutkkit	dutkit
dutkkojuvvon	dutkojuvvon
dutkosistis	dutkosisttis
duvdian	duvdilan
duš	dus
duššid	duššiid
dábalaččat	dábálaččat
dábalaš	dábálaš
dábaláččat	dábálaččat
dábálaccat	dábálaččat
dábálas	dábálaš
dábáleammosit	dábálepmosit
dádjulas	dádjolas
dádjá	dadjá
dáguid	dáiguid
dáhje	dahje
dáhkadusa	dáhkádusa
dáhkadusaid	dáhkádusaid
dáhkadusásahus	dáhkádusásahus
dáhkadusásahusat	dáhkádusásahusat
dáhkkat	dáhkat
dáhkkida	dáhkida
dáhkkádus	dáhkádus
dáhpahusa	dáhpáhusa
dáhpahuvvan	dáhpáhuvvan
dáhpahuvvš	dáhpáhuvvá
dáhpahuvva	dáhpáhuvvá
dáhppáhus	dáhpáhus
dáhpáhuvva	dáhpáhuvvá
dáhpáhuvvai	dáhpáhuvai
dáhpáhuvái	dáhpáhuvai
dáhpátuvvat	dáhpáhuvvat
dáhpšhuvvat	dáhpáhuvvat
dáhtolassii	dáhttolassii
dáhtušii	dáhtošii
dáhálaš	dehálaš
dáida	dáidda
dáidalaččat	dáiddalaččat
dáidarat	dáidárat
dáidariid	dáiddáriid
dáidariin	dáidáriin
dáiddagiin	dáidagiin
dáiddahistoriijja	dáiddahistorjá
dáiddaideaset	dáidduideaset
dáiddajuoji	dáiddaduoji
dáiddar	dáiddár
dáiddara	dáiddára
dáiddarat	dáiddárat
dáiddariid	dáiddáriid
dáiddarskuvllaid	dáiddárskuvllaid
dáiddavuose-husa	dáiddavuosehusa
dáiddavuose-hussii	dáiddavuosehussii
dáiddačehppiid	dáiddačehpiid
dáiddá	dáidá
dáiddárá	dáiddára
dáidguin	dáiguin
dáidibehket	dáidibehtet
dáinná	dáinna
dákkaraš	dakkáraš
dákkráriin	dákkáriin
dákstta	dávstta
dáktegávdnosaŧ	dáktegávdnosat
dálkkasččaide	dálkkaslaččaide
dálkkudanvuogit	dálkkodanvuogit
dálkkudit	dálkkodit
dállastiŧ	dállastit
dállobiireseŧ	dállobiireset
dálloluottaŧ	dálloluottat
dálločomaŧ	dálločomat
dáloniiddda	dáloniidda
dálvai	dálvái
dálve	dálvi
dálveguohtonÂ­eatnamiid	dálveguohtoneatnamiid
dálveÂ­guohtonÂ­eatnamiid	dálveguohtoneatnamiid
dálán	dalán
dárbbas	dárbbaš
dárbbaslaš	dárbbašlaš
dárbbašivččil	dárbbašivččii
dárbbašlaccat	dárbbašlaččat
dárbbašlas	dárbbašlaš
dárbbáš	dárbbaš
dárbbášii	dárbbašii
dárbbášit	dárbbašit
dárkkisduvvon	dárkkistuvvon
dárkkistiŧ	dárkkistit
dárkkujeaddjin	dárkkuheaddjin
dármumiidda	dárkumiidda
dárranit	dárránit
dáruiduhttemis	dáruiduhttimis
dáruiduhttenpolitihkas	dáruiduhttinpolitihkas
dáruiduhttenpolitihkka	dáruiduhttinpolitihkka
dáruiduhttenáigge	dáruiduhttináigge
dárumállet	dáromállet
dárumánáide	dárománáide
dárumánát	dárománát
dárvana	darvána
dárvanan	darvánan
dássai	dássái
dássalas	dássálas
dássasaš	dássásaš
dássažii	dassážii
dássediŧ	dássedit
dássehivuođa	dássehisvuođa
dásseárvo	dásseárvu
dássiid	dásiid
dássožii	dássážii
dássálagai	dássálagaid
dásto	dasto
dásá	dása
dátabáŋkku	databáŋkku
dátabáŋku	databáŋku
dáthtolaš	dáhtolaš
dávggaid	dávggáid
dávja	dávjá
dávvisámegillii	davvisámegillii
dávvirvuorkáid	dávvirvuorkkáid
dávvirvuorkáide	dávvirvuorkkáide
dáčč	dáčča
dáččaŧ	dáččat
dáččeavttuid	dáččaeavttuid
dáččá	dáčča
dáđistaga	dađistaga
dážža	dáčča
dåsis	dásis
død	Død
e.e	ee.
eadne	eadni
eahesihkarat	eahpesihkkarat
eahpedahtti	eahpidahtti
eahpeozolaccat	eahpeozolaččat
eahpesihkarat	eahpesihkkarat
eahpesihkarvuohtii	eahpesihkarvuhtii
eahpesihkkár	eahpesihkkar
eahpesihkkáris	eahpesihkkaris
eahpesihkár	eahpesihkar
eahpikeahttá	eahpitkeahttá
eahppedahtti	eahpidahtti
eahppesihkkar	eahpesihkkar
eahppidahtti	eahpidahtti
eahppitkeahttá	eahpitkeahttá
eaiggadaga	eaiggáda
eaiggadiidda	eaiggádiidda
eaiggadit	eaiggádit
eaiggaduvvo	eaiggáduvvo
eaiggádušša	eaiggáduššá
eaiggáduššamiš	eaiggáduššamis
eaiggáduššanháldduŧ	eaiggáduššanhálddut
eaiggáduššanvuoigatvuoda	eaiggáduššanvuoigatvuođa
eaiggáduššanvuoigatvuodas	eaiggáduššanvuoigatvuođas
eaiggáduššanvuoigatvuođ	eaiggáduššanvuoigatvuođa
eaiggáduššanvuoigavuohta	eaiggáduššanvuoigatvuohta
eaiggátmearkkaŧ	eaiggátmearkkat
eaiggátvuođahálddašeapmai	eaiggátvuođahálddašeapmái
eaigáda	eaiggáda
eaimmaide	eimmiide
eakspearttat	ekspearttat
eaktodahtolaš	eaktodáhtolaš
eaktodahttolaččat	eaktodáhtolaččat
eaktodáhtolaccat	eaktodáhtolaččat
ealahusa	ealáhusa
ealahusvugiidis	ealáhusvugiidis
ealalii	ealálii
ealat	ealáhat
ealgabivdiguin	ealgabivdiiguin
ealgaválliid	ealgavállaid
ealgá	ealga
eallemin	eallimin
ealluin	ealuin
ealáhusovddineapmi	ealáhusovddideapmi
ealáhusovddáneamis	ealáhusovdáneamis
ealáhusovddánemiide	ealáhusovdánemiide
ealáhusovdáneamiin	ealáhusovdánemiin
ealáhusovdáneapmai	ealáhusovdáneapmái
ealáhusovvdidanbarggus	ealáhusovddidanbarggus
ealáhussoahpámuša	ealáhussoahpamuša
ealáhusvisttid	ealáhusvisttiid
ealákahttet	ealáskahttit
ealáskahttemii	ealáskahttimii
ealásusovddideami	ealáhusovddideami
eambbohat	eambbogat
eambbosii	eambbosiid
eambogiid	eambbogiid
eambosiid	eambbosiid
eamiálbmogjid	eamiálbmogiid
eamiálbmotáirrasat	eamiálbmotáirasat
eanadatlágaŧ	eanadatlágat
eanadatsuodjalanguovlluŧ	eanadatsuodjalanguovllut
eanadivatsisaboađuŧ	eanadivatsisaboađut
eanadoallo	eanadoallu
eanadoalloministtarii	eanadoalloministarii
eanadoallošiehtádusain	eanadoallošiehtadusain
eanadoallui	eanadollui
eanaeaiggáduššanvuoigatvuodat	eanaeaiggáduššanvuoigatvuođat
eanagáhppalaga	eanagáhppálaga
eanagáhppalagat	eanagáhppálagat
eanamus	eanemus
eanandoallo	eanandoallu
eanandoalloministtariin	eanandoalloministariin
eananhálddašeápmái	eananhálddašeapmái
eanasa	eatnasa
eanavearuhuš	eanavearuhus
eanavuoigatvuodaid	eanavuoigatvuođaid
eandaliid	eandalii
eanelohku	eanetlohku
eanetbealaŧ	eanetbealát
eanetbut	eanebut
eanetloguálbmo-giid	eanetloguálbmogiid
eangalas	eaŋgalas
eara	eará
earago	earágo
earaid	earáid
earaide	earáide
earain	earáin
earan	earán
earat	earát
earemoamážit	earenoamážit
earenoamažit	earenoamážit
earenomažit	earenomážit
earranassii	earránassii
earrá	eará
earrálágan	earálágan
earáhuhttimiida	earáhuhttimiidda
earáidda	earáide
earálagan	earálágan
earáliigasii	earáliiggážii
earáliigasiidda	earáliiggážiidda
earáliiggas	earáliiggáš
earáliiggás	earáliiggáš
earánoamážit	earenoamážit
earánomáš	earenoamáš
earánomážit	earenomážit
easttagiid	eastagiid
eatnamiiidda	eatnamiidda
eatnamiim	eatnamiin
eatnamistis	eatnamisttis
eatnanvulošiid	eatnanvuložiid
eatnanvuodoža	eatnanvuloža
eatneriebu	eadneriebu
eatnigielasat	eatnigielaset
eatnám	eadnán
eatnánhearrá	eananhearrá
eatudan	eaktudan
eavttihasa	eavttohasa
eavttoheaddjiide	evttoheddjiide
eavttohusa	evttohusa
eavttuguin	eavttuiguin
eavttuŧ	eavttut
eaŋgelas	eŋgelas
effekta	effeakta
ehce	ehcce
eibmii	eaibmái
eiehtadusaid	šiehtadusaid
einnošii	einnostii
eisevaldiiguin	eiseválddiiguin
eiseváldiide	eiseválddiide
eiseváldiiguin	eiseválddiiguin
eiseváldiin	eiseválddiin
eisige	eisege
eisválddiid	eiseválddiid
eknomomálaš	ekonomalaš
ekonoamalaččat	ekonomalaččat
ekonoamalaš	ekonomalaš
ekonoamálaččat	ekonomalaččat
ekonoamálaš	ekonomalaš
ekonomia	ekonomiija
ekonomiijja	ekonomiija
ekonomiijjas	ekonomiijas
ekonomlaččat	ekonomalaččat
ekonomlaš	ekonomalaš
eksohtálaš	eksohtalaš
el-fábmolinjá	el-fápmolinjá
el-rávdnje	el-rávdnji
el-rávnjji	el-rávnnji
elektronikalaš	elektronihkalaš
elektrovnnlaš	elektrovnnalaš
elementtaid	elemeanttaid
elementtat	elemeanttat
elet	eret
eliid	elliid
emošuvnála	emošunála
empiiralaš	empiralaš
energia	energiija
energias	energiijas
engel	eŋgel
engelasgielas	eŋgelasgielas
engelat	eŋgelat
engelat;	eŋgelat;
engeliiguin	eŋgeliiguin
entreprenøraide	entreprenevrraide
entreprenørat	entreprenevrrat
entusiasta	entusiásta
ereanoamážit	erenoamážit
eremoamáš	erenoamáš
eren-oamáš	erenoamáš
eren-oamážit	erenoamážit
erenaomážit	erenoamážit
erenoamás	erenoamáš
erenoamáþit	erenoamážit
erenoamáčit	erenoamážit
erenoamš	erenoamáš
erenoamžit	erenomážit
erenoaámaš	erenoamáš
erenoemážit	erenoamážit
erenomoamážit	erenoamážit
erenoámaš	erenoamáš
erenoámažit	erenoamážit
ereoamašit	erenoamážit
ereonamážit	erenoamážit
ereonmáš	erenoamáš
ereŧ	eret
erit	eret
ernoamáš	erenoamáš
erohos	erohus
errnoamážit	erenoamážit
ert	eret
etnihkkalaš	etnihkalaš
etniinnis	etniinis
etnomusihkakguovddáža	etnomusihkkaguovddáža
etologalaš	etnologalaš
eurohpa	Eurohpá
eurohpameasttir	eurohpámeašttir
eurohpameaštirin	eurohpámeašttirin
eurohpá	Eurohpá
europeálaš	eurohpalaš
evangiljjoma	evangeliuma
evangiljjon	evangelium
evtohusain	evttohusain
evtohusat	evttohusat
evttohussa	evttohussan
evttohuvui	evttohuvvui
evttokas	evttohas
evttokassan	evttohassan
evttut	eavttut
eálán	ealán
eárá	eará
eŋgalsgiella	eŋgelasgiella
fabrihkkaráhkadun	fabrihkkaráhkaduvvon
fagasurggiid	fágasurggiid
fagábirrasii	fágabirrasii
fagáin	fágain
fahkkestaga	fáhkkestaga
faktor	fáktor
faktoriidda	fáktoriidda
faktoriin	fáktoriin
faleš	fales
fallat	fállat
fallskjearpma	seaivunliidni
fallá	fállá
faláldaga	fálaldaga
faláldat	fálaldat
famuin	fámuin
fanasgieddelaš	fanasgieddilaš
farisealaččát	farisealaččat
fartain	fárttain
faskkii	faskii
fast	fas
fasta	fásta
fastes	fasttes
fastit	fasttit
favllis	fávllis
feará	feara
fearámii	fearánii
fearámiidda	fearániidda
feaskaris	feaskáris
feastiválai	festiválii
feastonuohtiin	feastonuhtiin
feministalaš	feministtalaš
fertejuvvo	ferte
fertešivčče	fertešedje
fertešivččii	fertešii
fertijin	fertejin
festivala	festivála
festivalas	festiválas
festiválai	festiválii
fiberoptihkkalaš	fiberoptihkalaš
fidnat	fitnat
fidnodagaid	fitnodagaid
fidnodagain	fitnodagain
fidnodagat	fitnodagat
fiebmái	fierbmái
fierbmebivdovuoigatvuoda	fierbmebivdovuoigatvuođa
fierbmeráddjenguovlluŧ	fierbmeráddjenguovllut
fiervrridit	fievrridit
fiervrriduvvon	fievrriduvvon
fievrriduovvon	fievrriduvvon
fievrredanbargiŧ	fievrredanbargit
fiidna	fiidná
fiidnamus	fiidnámus
fiidnážiid	fiidnážit
fiinná	fiinna
filbmadahki	filbmadahkki
filbmafestiivala	filbmafestivála
filbmenaberáhta	filbmenapparáhta
fillešivčče	fillešedje
film-mastis	filmmastis
filmmai	filmmaid
filosifiaid	filosofiijaid
finansdepartemanta	finánsadepartemeanta
finansvuogádaga	finánsavuogádaga
finniis	fiinnis
finnmárkkolačča	finnmárkulačča
finnmárkku	Finnmárkku
finnmárkkuláčča	finnmárkulačča
finádan	finadan
finájoavkkuid	finálajoavkkuid
finálai	finálii
finánslavdegoddi	finánsalávdegoddi
finánslávdegoddi	finánsalávdegoddi
finánsvuogádaga	finánsavuogádaga
fiolehtta	fioleahtta
fioliinná	fioliinna
fitnejit	fidnejit
fitnemis	fidnemis
fitnii	fidnii
fitniiga	fidniiga
fitniime	fidniime
fitniimet	fidniimet
fitnje	fitne
fitnodatčiečamiid	fitnodatčiekčamiid
fjellfinnhua	Fjellfinnhua
foandii	fondii
formáilaide	formálaide
formálaččat	formálalaččat
forámálalaš	formálalaš
fossila	fossiila
frahkat	fráhkat
friddjaseabbo	friddjat
friddjavuođareivveŧ	friddjavuođareivvet
fridja	friddja
fridjasaji	friddjasaji
fridjavuohta	friddjavuohta
fridjavuođa	friddjavuođa
friiddja	friddja
friskka	friska
fulkkiguin	fulkkiiguin
fuobmaimet	fuobmáimet
fuobmajit	fuobmájit
fuobman	fuobmán
fuobmat	fuobmát
fuolalaccaŧ	fuolalaččat
fuolaštuvvan	fuolastuvvan
fuomaš	fuomáš
fuomašahttit	fuomášahttit
fuomašan	fuomášan
fuomašeddje	fuomášedje
fuomašeigga	fuomášeigga
fuomašin	fuomášin
fuomašit	fuomášit
fuomašuhttá	fuomášuhttá
fuomašumi	fuomášumi
fuomašuvvo	fuomášuvvo
fuomašuvvoje	fuomášuvvoje
fuomšin	fuomášin
fuonašit	fuonášit
fuonet	fuonit
fuopmá	fuobmá
fuopmái	fuobmái
fuopmájin	fuobmájin
fuopmájit	fuobmájit
fuopmán	fuobmán
fuopmát	fuobmát
fuorra	fuorrá
fuorragávpašeami	fuorragávppašeami
fuorragávppošeapmi	fuorragávppašeapmi
fuorrakunddáriid	fuorrakundáriid
fuođđoriggodagaŧ	fuođđoriggodagat
fylkkaboazo	fylkkaboazu
fylkkageaidnunehttii	fylkkageaidnonehttii
fylkkageaidnuplána	fylkkageaidnoplána
fylkkageainnuneahtas	fylkkageaidnoneahtas
fylkkageainnuplánas	fylkkageaidnoplánas
fylkkagirjerádjusii	fylkkagirjerádjosii
fylkkagirjerádjusiin	fylkkagirjerádjosiin
fylkkáin	fylkkain
fysioterapijja	fysioterapiija
fábmu	fápmu
fágagirjjalašvuohta	fágagirjjálašvuohta
fágalaccat	fágalaččat
fágaoahpahussain	fágaoahpahusain
fágálaš	fágalaš
fáhkát	váhkát
fáktoraid	fáktoriid
fál-lat	fállat
fáladaga	fálaldaga
fáladagaide	fálaldagaide
fáladagain	fálaldagain
fálla	fállá
fáládaga	fálaldaga
fáláldagaid	fálaldagaid
fáláldat	fálaldat
fámuhuhtui	fámuhuhttui
fánas	fanas
fángan	fáŋgan
fángavuhtii	fáŋgavuhtii
fángavuođas	fáŋgavuođas
fánggaid	fáŋggaid
fántaseremat	fantaseremat
fápmo	fápmu
fárgga	fargga
fárggamusat	farggamusat
fárrolágaid	fárrolagaid
fátmasta	fátmmasta
fátmastit	fátmmastit
fávdnadit	fávdnádit
fávorihtta	favorihtta
fáxen	fáksen
fáxet	fákset
fáŋgabargiidde	fáŋgabargiide
fáŋgán	fáŋgan
gafeja	kaféa
gahcahatvuoigatvuodaid	gahčahatvuoigatvuođaid
gahcahatvuoigatvuodain	gahčahatvuoigatvuođain
gahcahatvuoigatvuodat	gahčahatvuoigatvuođat
gahppira	gahpira
gaibidat	gáibidat
galduid	gálduid
galga	galgá
galgai	galggai
galgaše	galggaše
galgašii	galggašii
galggaigga	galggaiga
galggašeaigga	galggašeigga
galggaši	galggašii
galggašivčče	galggašii
galggái	galggai
galggášii	galggašii
galgái	galgá
galladin	galládin
gallanan	gallánan
gallas	gallás
ganddat	gánddat
ganttestuvvet	gantteštuvvet
gappus	gáppus
garasiid	garrasit
gardai	gárdái
garihuhttá	gárihuhttá
garja	garjá
garnisuvnnat	garnisovnnat
garraseamosit	garrasepmosit
garrodit	garrudit
garrásit	garrasit
garvvis	gárvvis
garvánit	gárvánit
garžžideapmin	gáržžideapmin
gaska-ahkásaš	gaskaahkásaš
gaskaboddosaccat	gaskaboddosaččat
gaskaboddosaččaŧ	gaskaboddosaččat
gaskaboddosččaide	gaskaboddosaččaide
gaskaid	gaskkaid
gaskamuttos	gaskkamuttus
gaskaneaneaset	gaskaneaset
gaskarievttiš	gaskarievttis
gaskaváhko	gaskavahku
gaskkaiduvvá	gaskkalduvvá
gakkal	gaskal
gaskkavuohta	gaskavuohta
gaskku	gasku
gaskkálduvvat	gaskkalduvvat
gaskohagaid	gaskkohagaid
gaslggaše	galggaše
gassege	goassege
gaup	Gaup
gavcci	gávcci
gavdnan	gávdnan
gavdnat	gávdnat
gavdno	gávdno
gavdná	gávdná
gavnna	gávnna
gavnnaheigga	gávnnaheigga
gavno	gávdno
gavpebáikái	gávpebáikái
gavpolmmai	gávpeolmmái
gazaldaga	gažaldaga
gazzastan	gaccastan
gazzastuvvo	gaccastuvvo
geaddus	geaiddus
geadgelágit	geađgelágit
geafivuoa	geafivuođa
geagrafálaččat	geográfalaččat
geah-ččit	geahččit
geahccat	geahččat
geahka	geahká
geahpádeapmi	geahpadeapmi
geahčadeapmai	geahčadeapmái
geahčadia	geahčada
geahčalan	geahččalan
geahčatahkii	geahčastahkii
geahčá	geahččá
geahčča	geahččá
geahččen	geahčen
geahččuide	geahčuide
geai-dudeaddji	geiddodeaddji
geainguin	geaiguin
gealbbudahtti	gealbudahtti
gearde	geardde
gearduhii	geardduhii
gearpmáš	gearpmaš
geassa	geassá
geasse	gease
geasseorogat	geasseorohat
geassádá	geassáda
geastige	geastege
geasuheadje	geasuheaddji
geatkit	geatkkit
geatnegagasvuođaide	geatnegasvuođaide
geatnegahttejit	geatnegahttet
geatnegahttejuvvon	geatnegahttojuvvon
geatnegasvuođ	geatnegasvuođa
geatnegattot	geatnegahttot
geatnegáhttá	geatnegahttá
geatnogahtton	geatnegahtton
geavaga	geavaha
geavahandilálašvuođaŧ	geavahandilálašvuođat
geavahanvuoigatvuoda	geavahanvuoigatvuođa
geavahanvuoigatvuodas	geavahanvuoigatvuođas
geavaheaddái	geavaheaddjái
geavaheameš	geavaheames
geavaheapmai	geavaheapmái
geavahepmi	geavaheapmi
geavahuvo	geavahuvvo
geavahá	geavaha
geavhana	geavahan
geavva	geavvá
geaváhuvvon	geavahuvvon
geađgeeiggi	geađgeáiggi
geaŧki	geatki
geaŧkki	geatkki
gedosis	geidosis
gehtte	gehte
gehčadeapmai	geahčadeapmái
gehččit	gehččiid
gelbolašvuođahuksemiid	gelbbolašvuođahuksemiid
genretriijalaččaide	geretriijalaččaide
geografalaccat	geográfalaččat
geográfálaš	geográfalaš
geretriijalžžii	geretriijalažžii
gergujuvvui	gergojuvvui
getkiid	getkkiid
gi	gii
gida	giđa
giddagasás	giddagasas
giddegassii	giddagassii
giebahuhttan	giebahuhttán
giedahallá	gieđahallá
giehtalága	giehtalaga
giehttaduoddjái	giehtaduodjái
gielaoahppaheapmai	giellaoahpaheapmái
gieldabarggiide	gieldabargiide
giellabiesi	giellabeasi
giellanjuolggasusaid	giellanjuolggadusaid
giellarádi	giellaráđi
gierda	gierdá
gierdatmeahttumiidda	gierdameahttumiidda
gievvolaš	gievvulaš
gieđavuollai	gieđavuollái
gihpagačča	gihppagačča
giisavuođus	giisávuođus
giitii	giittii
giitta	gitta
giljobaša	giljobačča
gillajumiid	gillájumiid
gillan	gillán
gillaraiid	gillariid
gillat	gillát
gilljáda	giljáda
gilláimušastis	gillámušastis
gilvvakeahttá	gilvvikeahttá
girddet	girdet
girdifidnodagain	girdifitnodagain
girdinšilljut	girdinšiljut
girdiseaivunšiljju	girdiseaivunšilju
girdisealskáhpat	girdiselskáhpat
girdišilljuid	girdišiljuid
girdišilljuide	girdišiljuide
girdišilljuiguin	girdišiljuiguin
girdišilljuin	girdišiljuin
girjebálkášumi	girjebálkkašumi
girjerádjusa	girjerádjosa
girjerádjusbálvalusaid	girjerájusbálvalusaid
girječáliid	girječálliid
girjiid	girjjiid
girjjalašvuođa	girjjálašvuođa
girjjača	girjjáža
girjjid	girjjiid
girjjistit	girjjistis
girjjálašvuoa	girjjálašvuođa
girjjálašvuoas	girjjálašvuođas
girkohearra	girkohearrá
girkustit	girkustis
gisttáid	gistáid
gitarra	gitárra
gittá	gitta
givssiidin	givssidin
givssuide	givssiide
givásii	giivásii
giđabeallai	giđabeallái
giđasdálvvi	giđasdálvve
giđá	giđa
giđđajietnjačáhci	giđđajiekŋačáhci
gižu	giža
gnddat	gánddat
goabba	goabbá
goabbage	goabbáge
goabbašat	goappašat
goaberdávda	guoberdávda
goabir	guobir
goalmmadin	goalmmádin
goalmmat	goalmmát
goappa	goappá
goappage	goappáge
goappašaga	goappašagat
goappašage	goappásge
goappašet	goappašat
goappešit	goappešiid
goappášagat	goappašagat
goarggustallin	goarggostallin
goasesge	goassege
goasi	goasii
goaskina	goaskima
goaskiniid	goaskimiid
goassega	goassege
goassiige	goassige
goastarássešilju	goanstarássešilju
goavddiŧ	goavddit
goddesáhpaniid	goddesáhpániid
gohccekeahttá	gozekeahttá
gohčoduvo	gohčoduvvo
gohččamuššii	gohccámuššii
gohččuda	gohččoda
gohččujuvvun	gohččojuvvon
gohččán	gohccán
gohččát	gohccát
goikebiergut	goikebierggut
goikkebuoiddi	goikebuoiddi
goikáid	goikkehiid
goitege	goitge
goitot	goittot
goitotge	goittotge
goittoge	goittotge
gokcat	gokčat
gokcá	gokčá
gokča	gokčá
gokčojuvo	gokčojuvvo
golatkeahtta	golatkeahttá
golbmagoalmmatlotduhát	golbmagoalmmátlohkáiduhát
golbmaloht	golbmalot
golbmalotgeardásaččat	golmmalotgeardásaččat
golbmalotjahkásaš	golmmalotjahkásaš
golbmása	golbmasa
golbmásis	golbmasis
golf-časkima	golfačaskima
golf-časkimin	golfačaskimin
golf-časkimis	golfačaskimis
golf-časkin	golfačaskin
golggida	golggiida
golmmadagaide	goalmmádasaide
golmmadahkii	goalmmádassii
golmmadat	goalmmádat
golmmaoasát	golmmaoasat
golmmá	golmma
golmmás	golmmas
gomovuođa	gomuvuođa
gonagasreabbabivdui	gonagasreabbábivdui
gonagasreabbáid	gonagasreappáid
gonagasriikkii	gonagasriikii
gonagsreabbámáddodagat	gonagasreabbámáddodagat
gorudit	gorudat
gorzziin	goržžiin
gorževuoigatvuodaid	gorževuoigatvuođaid
gottahalai	gottáhalai
gottahallan	gottáhallan
gottahalle	gottáhalle
gottehagaide	gohttehagaide
gottehahkii	gohttehat
gottid	gottiid
govdabádde	govdabáddi
govdafierbmefylkkii	govdafierbmefylkii
govtte	guovtti
govttohemet	govttoheamit
govvafirji	govvagirji
govvenaperáhta	govvenapparáhta
govvenapparahta	govvenapparáhta
govvidedjiide	govvideddjiide
govviduvvujit	govviduvvojit
govádagat	govadagat
gozihanmihttideapmin	gozihanmihtideapmin
gođáfáhcca	gođafáhcca
grada	gráda
grafálaš	gráfalaš
gramatihkka	grammatihkka
grehkalaš	greikkalaš
grenselinja	rádjelinjá
grillrestauránta	grillarestoráŋŋa
gudjejin	guđjejin
gudnibálkkášupmi	gudnebálkkašupmi
gudnimielahttovuođa	gudnemiellahttovuođa
guffariin	goaffariin
guhkas	guhkás
guhkeduvui	guhkiduvvui
guhkelebbui	guhkkelebbui
guhkelii	guhkkelii
guhkeliidda	guhkkeliidda
guhkelis	guhkkelis
guhkilii	guhkkelii
guhkitáigai	guhkitáigái
guhkkeleabbui	guhkkelebbui
guhkkeli	guhkkelii
guhkkes	guhkes
guhkkiduvvot	guhkiduvvot
guhkkimusat	guhkimusat
guhkodaga	guhkkodaga
guhkosaš	guhkkosaš
guhta	guhtta
guhtojuvvo	guhttojuvvo
guhttaliid	guhtaliid
guimmiset	guoimmiset
guit	goit
guitot	guittot
guktut	guktot
gulaahussii	gulahussii
gulaskuddanma	gulaskuddama
gulaskullamiidda	gulaskuddamiidda
gulaskuttamis	gulaskuddamis
gulddálmasaid	gulddalmasaid
gulla	gullá
gullahallaninstánsa	gulahallaninstánsa
gullai	gulai
gullogovaid	gullugovaid
gulvui	guvlui
gulái	gulai
guláskuddamii	gulaskuddamii
guláskuddamiid	gulaskuddamiid
guláskuddamiidda	gulaskuddamiidda
guláskuddan	gulaskuddan
guláskuddancealkámušaid	gulaskuddancealkámušaid
guláskuddanáiggi	gulaskuddanáiggi
guláskuddanáigi	gulaskuddanáigi
guláskuddat	gulaskuddat
guoddalanásahuš	guoddalanásahus
guohppárdárogielas	guohpárdárogielas
guohtonÂ­eatnamiid	guohtoneatnamiid
guohtovuoigavuohta	guođohanvuoigatvuohta
guohttehehket	guottehehket
guoikkanas	goaikkanas
guoikkanasat	goaikkanasat
guoktasa	guoktása
guoktegávdnái	guovttegávdnái
guokteloht	guoktelot
guoktelotduháhiin	guoktelogiduháhiin
guoktelotduhát	guoktelogiduhát
guokten	guoktin
guoktenuppelotjahkásaš	guovttenuppelotjahkásaš
guolelfoanddas	guollefoanddas
guolelhálddašan	guollehálddašan
guolle	guolli
guollebiepmama	guollebiebmama
guollebiepmanrusttegat	guollebiebmanrusttegat
guollebivdovuoigatvuoda	guollebivdovuoigatvuođa
guollebivdovuoigatvuodaid	guollebivdovuoigatvuođaid
guollebivdovuoigatvuodaideaset	guollebivdovuoigatvuođaideaset
guollebivdovuoigatvuodain	guollebivdovuoigatvuođain
guollebivdovuoigatvuodat	guollebivdovuoigatvuođat
guolleboránis	guolleboranis
guolledikšunbivdimiš	guolledikšunbivdimis
guollenjálga	guollenjálgá
guolmmát	goalmmát
guolásteddjit	guolásteaddjit
guolástusministtara	guolástusministara
guooibmás	guoibmás
guooktelogátnuppi	guokteloginuppi
guora-hallá	guorahallá
guorahalla	guorahallá
guorbmevávdnageainnuŧ	guorbmevávdnageainnut
guoska	guoská
guoskagoahta	guoskagoahtá
guoskeváš	guoskevaš
guoskká	guoská
guosselogaldallamistis	guosselogaldallamisttis
guosská	guoská
guovdageainnulaš	guovdageaidnulaš
guovddačis	guovddážis
guovddása	guovddáža
guovddázžiidda	guovddážiidda
guovddášbelodat	guovddášbellodat
guovddášhálddahuš	guovddášhálddahus
guovdo	guovdu
guovllomeaštira	guovllumeaštára
guovllos	guovllus
guovlluguovdásaš	guovlluguovdasaš
guovlloguovdasaš	guovlluguovdasaš
guovllulaccat	guovlulaččat
guovllolaš	guvllolaš
guovlluglas	guvllolaš
guovllunisonguovddáš	guovllunisoguovddáš
guovloekolagalaš	guovloekologalaš
guovlolaš	guovlulaš
guovluin	guovlluin
guovluministtar	guovloministtar
guovlupolitihkka	guovlopolitihkka
guovluráđiin	guovlluráđiin
guovssahas	guovssahasat
guovssahasa	guovssahasaid
guovssahassii	guovssahasaide
guovssugeaži	guovssogeaži
guovttebealaŧ	guovttebealat
guovttegielalašvuoda	guovttegielalašvuođa
guovtteoasaŧ	guovtteoasat
guovtteoasát	guovtteoasat
guovtteolil	guovtteollil
guovtteolilis	guovtteollilis
guovttesuoraŧ	guovttesuorat
guovttus	guovttos
guovvluin	guovlluin
guovčča	guovžža
guođohit~	guođohit
guođá	guođđá
gurotbellodaga	gurutbellodaga
gurpmjid	gurpmiid
gurutbellodag	gurutbellodat
gustojeddji	gustojeaddji
gustošivčče	gustošedje
gusáid	gusaid
guvhlariid	guvhlláriid
guvllui	guvlui
guvlluin	guovlluin
guđostahttet	guođostahttet
guđá	guđa
guška	gušká
gáVdnosat	gávdnosat
gábidivčče	gáibidivčče
gáddai	gáddái
gáddevuoigatvuodat	gáddevuoigatvuođat
gádnat	gávdnat
gáfadiš	gáfadis
gáfejai	kaféii
gáhppalaga	gáhppálaga
gáhppalagas	gáhppálagas
gáibadus	gáibádus
gáibadusa	gáibádusa
gáibadusaid	gáibádusaid
gáibadusat	gáibádusat
gáibida	gáibida
gáibideada	gáibideaba
gáibiduvvojiŧ	gáibiduvvojit
gáibiđivččii	gáibidivččii
gáibádii	gáibidii
gáibádusamet	gáibádussamet
gáibádusaŧ	gáibádusat
gáibáduš	gáibádus
gáiddusjohttimaŧ	gáiddusjohtimat
gáididahkes	gáibidahkes
gáidánuohtiin	gáidánuhtiin
gáikkodit	gaikkodit
gáinuhtiin	gáidánuhtiin
gáissaid	gáissáid
gáissat	gáissát
gál	gal
gálbmojit	galbmojit
gálbmot	galbmot
gálbmu	galbmo
gáldduid	gálduid
gáldit	gáldet
gálgaše	galggaše
gálggadeamuš	gálggadeamoš
gálvejohttu	gálvojohtu
gánga	gáŋga
gánggaid	gáŋggaid
gánggain	gáŋggain
gánggáiguin	gáŋggaiguin
gánnaha	gánnáha
gánnahahtti	gánnáhahtti
gánneta	gánneha
gánnnehahtti	gánnehahtti
gánnáhahttii	gánnáhahtii
gápogis	gávpogis
gáranasaŧ	gáranasat
gárddii	gárddiid
gárggiideamiin	gárggiidemiin
gárpi	garpi
gárppiide	garppiide
gárpái	garpái
gárrenmirkkoid	gárrenmirkkuid
gárvan	gárván
gárvana	gárvána
gárvanan	gárvánan
gárvanii	gárvánii
gárvanit	gárvánit
gárvanivččii	gárvánivččii
gárvasit	gárvásit
gárvá	gárvásat
gáržžekeahttá	gáržžitkeahttá
gáržžetkeahttá	gáržžitkeahttá
gáržžikeahttá	gáržžitkeahttá
gáskamuttus	gaskamuttus
gáskas	gaskkas
gáskkasit	gáskkašit
gáskkedan	gáskkiidan
gáskkimis	gáskimis
gássáid	gáissáid
gátjut	gádjut
gáttan	gáttán
gáttat	gáttát
gávccat	gávccát
gávccejahkásaš	gávccijahkásaš
gávccenuppelogis	gávccinuppelogis
gávccenuppelot	gávccinuppelot
gávdna	gávdná
gávdnakeahttá	gávnnakeahttá
gávdnojumiŧ	gávdnojumit
gávdnujit	gávdnojit
gávdnun	gávdnon
gávnnhan	gávnnahan
gávotgazzaid	gávotgaccaid
gávpejasaŧ	gávpejasat
gávpejassearvviŧ	gávpejassearvvit
gávppoga	gávpoga
gávppogii	gávpogii
gávppogiidda	gávpogiidda
gávppogis	gávpogis
gávppošedje	gávppašedje
gávppošit	gávppašit
gážaldagaid	gažaldagaid
gážaldat	gažaldat
hahká	háhká
halddašanláš	hálddahuslaš
halddášeami	hálddašeami
halidehpet	háliidehpet
halidit	háliidit
hallat	hállat
have	háve
havkan	hávkan
havski	hávski
heahpát	heahpat
heahtidilli	heahtedilli
heaitihin	heaittihit
heaitihit	heaittihit
heaitthit	heaittihit
heaittiheameš	heaittiheames
heaittihuvui	heaittihuvvui
heaiveheami	heiveheami
heaivet	beaivet
heajomus	heajumus
heajot	heajut
heakkaheahtáhaš	heakkaheahtahaš
healbahit	healbadit
heallumálemaŧ	heallomálemat
heanggastuvvojit	heaŋggastuvvojit
heardduhemiid	hearddohemiid
heastavuoddjimat	heastavuodjimat
heađáláččaid	heađálaččaid
heaŋga	heaŋgá
heddjonan	hedjonan
hehtara	hehtára
heitihit	heaittihit
heitogat	heittogat
heittihit	heaittihit
heivehallaŧ	heivehallat
heiveheapni	heiveheapmi
heivolaš	heivvolaš
hengojit	heŋgojit
hettihuvvot	heaittihuvvot
heŋggojuvvon	heŋgojuvvon
hilgunfanasortneŧ	hilgunfanasortnet
hirbmastuvvan	hirpmástuvvan
hirbmát	hirbmat
hirpmastuvvan	hirpmástuvvan
hirpmáhuvvai	hirpmahuvai
historihkár	historihkar
historiijjás	historjjás
historja	historjá
historjagirjjiid	historjágirjjiid
historjagirjjit	historjágirjjit
historjasearvi	historjásearvi
historjaservviide	historjáservviide
historjii	historjái
historjja	historjjá
historjjalaš	historjjálaš
historjjaláš	historjjálaš
historjjas	historjjás
historjjasearvvit	historjásearvvit
hliidit	háliidit
hoahkkala	hoahkala
hobehiŧ	hobehit
hoffain	hoavain
hohtet	bohtet
homofiilaid	homofiillaid
homofiilalaš	homofiillalaš
homofiliášši	homofiilaášši
homofiliáššis	homofiilaáššis
hovddejuvvojit	hovdejuvvojit
hu	hui
huikimiida	huikimiidda
hukse-juvvon	huksejuvvon
huksejuvui	huksejuvvui
huksenkeahttá	huksekeahttá
hukseáššiid	huksenáššiid
huksešivčče	huksešedje
humašivččii	humašii
humoristalaččat	humoristtalaččat
humoristalaš	humoristtalaš
humádi	humadii
huob-máiga	huobmáiga
huorre	buorre
hupmán	hupman
hupmát	hupmat
hutkaivuođa	hutkáivuođa
hutkamokta	hutkanmokta
hutkkás	hutkás
huškkesta	huškkasta
huškkestit	huškkastit
huškobeahtti	huškubeahtti
hvddaheapme	huvddaheapme
hymn-aid	hymnaid
hyttá	hytta
hyttái	hyttai
hyttás	hyttas
há-miid	hámiid
háddesupmi	haddesupmi
háddi	haddi
háddjana	hádjána
háddjanan	hádjánan
háddjanit	hádjánit
hádje	háddje
háhpardahttá	háhpárahttá
háhtteŧ	háhttet
hálbbibin	hálbbibun
háldašeami	hálddašeami
hálddahuseisseváldiide	hálddahuseisseválddiide
hálddahuslaccat	hálddahuslaččat
hálddahussi	hálddahussii
hálddasit	hálddašit
hálddašangeavaŧ	hálddašangeavat
hálddašeamiin	hálddašemiin
hálddašeapmai	hálddašeapmái
hálddet	háldet
háldidivčče	háliidivčče
háldiida	háliida
háledit	háliidit
hálidá	háliida
hálii	hállii
hálkkui	bálkkui
hálkogonagaš	hálkagonagas
hállagoahtet	hállagohtet
háltiide	hálttiide
hápmet	hábmet
hárdášit	hárddašit
hárjahallamiin	hárjehallamiin
hárjanan	hárjánan
hárjaneapmi	hárjáneapmi
hárjanit	hárjánit
hárje-hallagoahtán	hárjehallagoahtán
hárjehalanáiggiid	hárjehallanáiggiid
hárjehallamiida	hárjehallamiidda
hárjáhallan	hárjehallan
hárvebut	hárvvibut
hásttalusaid	hástalusaid
hástálussan	hástalussan
hátti	hatti
háttiid	hattiid
háttit	hattit
hávdaduvvot	hávdáduvvot
hávdeboraŧ	hávdeborat
háven	hávvin
háves	hávis
hávskas	hávskás
hávskkit	hávskit
hávsse	havsse
iF	IF
idealistalaš	idealisttalaš
iden-titehta	identitehta
ideđis	iđedis
ieas	iežas
ieaset	iežaset
ieažas	iežas
ieažaset	iežaset
ieguđetlágan	iešguđetlágan
iehcanas	iehčanas
iehččanassii	iehčanassii
ienastanlihppu	jienastanlihppu
ieseaiggáŧ	iešeaiggát
iezas	iežas
ieš-guđetlágan	iešguđetlágan
iešbukorre	iešbuorre
iešgu-đetlágan	iešguđetlágan
iešgudet	iešguđet
iešgudetge	iešguđetge
iešgudetlágan	iešguđetlágan
iešguđelágan	iešguđetlágan
iešguđete	iešguđetge
iešguđetlagan	iešguđetlágan
iešjávrris	Iešjávrris
iešluohtttámuš	iešluohttámuš
iešmearredeami	iešmearrideami
ieštivrajupmi	iešstivrejupmi
ieštivrejumi	iešstivrejumi
ieštivrejumis	iešstivrejumis
ieštivrejupmi	iešstivrejupmi
iežadeamet	iežaideamet
iežadeatte	iežaideatte
iežadeattet	iežaideattet
iežaineasetguin	iežaineaset
iežanassii	iehčanassii
iežaseat	iežaset
iežasga	iežaska
iežasgova	iešgova
iežasit	iežaset
iežaskka	iežaska
iežaš	iežas
iežái-guin	iežáiguin
ihcalas	ihcalis
ihkenassii	ihkinassii
ihkinas	ihkenas
ihkkinassii	ihkinassii
ihku	ihkku
ihtiin	ihttin
ihtohalái	ihttohalai
ijá	ija
ilhmi	ilbmi
ille	illá
illudetje	illudedje
ilmmuheamiid	ilmmuhemiid
ilmmái	ilmmai
iludet	ilodet
ilusin	ilus
imaštallai	imaštalai
imaštálla	imaštallá
imášin	imašin
imášlaš	imašlaš
imáštalan	imaštalan
imáštallan	imaštallan
imáštallat	imaštallat
imáštallá	imaštallá
in-strumeanttat	instrumeanttat
inceastta	inseastta
incesta	inseasta
individa	indiviida
industiijabáikái	industriijabáikái
industriai	industriijai
industrialaš	industriijalaš
industriijačiidda	industriijažiidda
industriijjain	industriijain
inga	Inga
ingeniørat	ingenievrrat
iniatiiva	initiatiiva
iniatiivvat	initiatiivvat
inkasso	inkásso
innoatiiva	innovatiiva
inspirašudvii	inspirašuvdnii
inspirerejuvvun	inspirerejuvvon
instituhtii	instituhttii
instruksaid	instruvssaid
instrumentai	instrumentii
inteligeansa	intelligeansa
inteligeansaide	intelligeanssaide
inteligeanttaide	intelligeanttaide
inteligensii	intelligensii
inteligentii	intelligentii
internahta	internáhta
internašunálalaččat	internašuvnnalaččat
interneta	Interneta
internáhtti	internáhttii
internášunálalaččat	internašuvnnalaččat
intrimstivras	interimstivrras
inuihttalaš	inuihtalaš
inuit	inuihta
ipmardusa	ipmárdusa
ipmidit	ipmirdit
ipmird	ipmir
ipmirmeahttuneabbo	ipmirmeahttuseabbo
ipmárdit	ipmirdit
ipmášiid	ipmašiid
isidas	isidis
iska	iskka
iskademiidda	iskkademiide
iskanvuoigatvuoda	iskanvuoigatvuođa
iskkademiidda	iskkademiide
isolašudvii	isolašuvdnii
issopa	iissopa
issotgeahčái	iissotgeahčái
itálijagiela	itáliagiela
ivgogákti	Ivgu-gákti
ivgogáktái	Ivgu-gáktái
ivgogávtti	Ivgu-gávtti
ivgudialeavttas	Ivgu-dialeavttas
ivgugávttiid	Ivgu-gávttiid
ivnnat	ivnnát
jaa	ja
jaga	jagi
jagii	jagiid
jagimalle	jagimálle
jagás	jagáš
jagáá	jagáš
jahkai	jahkái
jahkan	jáhkán
jahkasaččaide	jahkásaččaide
jahkasaš	jahkásaš
jahkašas	jahkásaš
jahke	jáhke
jahkediedáhus	jahkedieđáhus
jahkehahtti	jáhkehahtti
jahkemolssomis	jahkemolsumis
jahkenjealljehasas	jahkenjealjehasas
jahkečoakkin	jahkečoahkkin
jahkkehahtti	jáhkehahtti
jahkkit	jáhkkit
jahkku	jáhkku
jahkkásaš	jahkásaš
jahkásaccat	jahkásaččat
jahkásáš	jahkásaš
jalddán	jálddán
jalden	jálden
jaldit	jáldit
janitsarmusihkka	janitsjarmusihkka
jas	ja
jaskka	jaska
jaskkes	jaskes
javkaduvvot	jávkaduvvot
javkán	jávkan
javrris	jávrris
javrrit	jávrrit
jea	ja
jeagelrajis	jeagelrájis
jeaguheapmin	jeagoheapmin
jeahkala	jeahkála
jeahkaliid	jeahkáliid
jeahkaliin	jeahkáliin
jeahkalis	jeahkális
jearaladat	jearaldat
jearatgeahtta	jearatkeahttá
jearatgeahttá	jearakeahttá
jearhallat	jearahallat
jearldat	jearaldat
jearra	jearrá
jearrai	jearai
jeinastit	jienastit
jieanaid	jienaid
jieanastit	jienastit
jieanstit	jienastit
jiekŋagovžžaid	jiekŋaguovžžaid
jienadan	jienádan
jienadit	jienádit
jienastanvuoigaduvvan	jienastanvuoigaduvvon
jienastuslogua	jienastuslogus
jienastuvo	jienastuvvo
jienja	jieŋa
jienjaid	jieŋaid
jienjain	jieŋain
jienjat	jieŋat
jietnedan	jietnadan
jietnja	jiekŋa
jietnjajávrri	jiekŋajávrri
jietnjan	jiekŋan
jiktevihkái	jiektavihkái
jirpmet	jirbmet
jirpmiinnis	jirpmiinis
jitnjon	jikŋon
joatka	joatká
joatkaoahpahusain	joatkkaoahpahusain
joatkaoahpahussii	joatkkaoahpahussii
joatkaskuvla	joatkkaskuvla
joatkaskuvlii	joatkkaskuvlii
joatkaskuvlla	joatkkaskuvlla
joatkaskuvllas	joatkkaskuvllas
joatkaskuvllat	joatkkaskuvllat
joatkašupmi	joatkkašupmi
joatkkaohppofálaldaga	joatkkaoahppofálaldaga
joatkkaohppofálaldagaid	joatkkaoahppofálaldagaid
joatkkaohppofálaldagaide	joatkkaoahppofálaldagaide
joatkkaohppofálaldagat	joatkkaoahppofálaldagat
joatkkaohppofálaldahkii	joatkkaoahppofálaldahkii
joatkkaohppofálaldat	joatkkaoahppofálaldat
joatkkašuvvá	joatkašuvvá
joatkká	joatká
joatkkášuvvá	joatkašuvvá
joatkkimis	joatkimis
joavk-kuinis	joavkkuinis
joavkkui	jovkui
joavkulatnja	joavkolatnja
jodašedje	jođašedje
jodiheaddji	jođiheaddji
jodihit	jođihit
jogážis	jogažis
johkabuoddun	johkabuođđun
johkosat	juhkosat
johká	johka
johtalussihkkárvuođaplána	johtalussihkkarvuođaplána
johtan	johtán
johtasaŧ	johtasat
johtileamosit	johtilepmosit
johtipokála	johttipokála
johtkkaskuvlla	joatkkaskuvlla
johtogeavli	johtugeavli
johtolas	johtálas
johtolatvuoigatvuođ	johtolatvuoigatvuođa
johttimii	johtimii
johttimiin	johtimiin
johttimin	johtimin
johttivuovdinbuvriid	johttivuovdinbuvrriid
johtulagaide	johtolagaide
johtulat	johtolat
johtulatlávdegoddi	johtolatlávdegoddi
johtulatsurggiid	johtolatsurggiid
johtálusvisti	johtalusvistti
johtát	johttát
joksa	joksá
jordamor	jorddamovra
jordamorbálvalus	jorddamovrabálvalus
jordamorbálvalusas	jorddamovrabálvalusas
jorddamorat	jorddamovrat
jorgaleapmai	jorgaleapmái
jorggaluvvon	jorgaluvvon
jorggahallat	jorggáhallat
jotkii	jotkkii
jotkiimet	jotkkiimet
journalistaid	journalisttaid
jovkkos	jovkkoš
jovkkuid	joavkkuid
jovkkuide	joavkkuide
joávku	joavku
joðanit	jođánit
joðiheadji	jođiheaddji
jođahaga	jođáhaga
jođahaga;	jođáhaga;
jođan	jođán
jođaneamos	jođáneamos
jođaneappot	jođáneappot
jođanepmosit	jođánepmosit
jođanis	jođánis
jođanit	jođánit
jođeheaddji	jođiheaddji
jođihanlinnjaid	jođihanlinnjáid
jođihanlinnjat	jođihanlinnját
jođiheaddi	jođiheaddji
jođiheaddjiidn	jođiheddjiid
jođiheaddjji	jođiheaddji
jođiheadji	jođiheaddji
jođáneamosit	jođánepmosit
jugo	juogo
juhkkan	juhkan
juhkkojuvui	juhkkojuvvui
juhkojuvvon	juhkkojuvvon
juhkojuvvot	juhkkojuvvot
juhkojuvvojit	juhkkojuvvojit
juhkojuvvui	juhkkojuvvui
juhkámušaid	juhkamušaid
juiggiid	juigiid
julggásteami	julggašteami
julggástii	julggaštii
julggástusa	julggaštusa
julggášta	julggašta
julggáštit	julggaštit
julggáštusa	julggaštusa
julggáštusastis	julggaštusastis
juogakeahttá	juogatkeahttá
juogalagan	juogalágan
juohehaš	juohkehaš
juohkinkeahttá	juogakeahttá
juohkke	juohke
juohkká	juohká
juoida	juoidá
juoiga	juoigá
juoiggadisgohte	juoiggadišgohte
juoke	juohke
juolgeladdasat	juolgelađđasat
juolldudan	juolludan
juolloda	juolluda
juollodan	juolludan
juolludeamiid	juolludemiid
juološii	jullošii
juornlisttálaš	journalisttalaš
juornála	journála
juornálaide	journálaide
juornálii	journálii
juovllamánu	juovlamánu
jurdagit	jurdagiid
jurddasii:	jurddašii:
jurddašepmi	jurddašeapmi
jurddá	jurdda
juridihkalaccat	juridihkalaččat
juridihkkalaš	juridihkalaš
juridihkkálaš	juridihkalaš
juridihkálaš	juridihkalaš
jursita	jurista
jursitta	juristta
jursittaid	juristtaid
jursittaiguin	juristtaiguin
justisministtariin	vuoigatvuođaministariin
justisministáriin	justisministariin
juvddálačcat	juvddálaččat
juvssahattin	juvssahahttin
jábme	jápme
jábmima	jápmima
jábmimii	jápmimii
jágaš	jagáš
jáhkasadjat	jahkásaččat
jáhkehahtte	jáhkehahtti
jáhkehahttevuođa	jáhkehahttivuođa
jáhkehahttimii	jáhkehahttái
jáhkehahttimiidda	jáhkehahttiide
jáhkemeahttun	jáhkkemeahttun
jáhkimis	jáhkkimis
jáhkkehahtti	jáhkehahtti
jáhkkimes	jáhkkimis
jáhkkásaš	jahkásaš
jáhká	jáhkká
jáhkásaš	jahkásaš
jánddur	jándor
jándoriii	jándorii
jápman	jápmán
jápmiid	jábmiid
jávohuvvaleimmet	jávohuvaleimmet
kahpihttal	kapihtal
kalkulatorain	kalkuláhtoriin
kampánjain	kampánjjain
kamuflasjebiktasa	kamuflášabiktasa
kamuflašebiktasa	kamuflášabiktasa
kanada	Kanada
kandake	Kandake
kantina	kantiina
kantinna	kantiinna
kanturhálddahuslaš	kánturhálddahuslaš
kapellana	kapellána
kapitala	kapitála
kapitalat	kapitálat
kapteaidná	kapteaidna
karantenai	karantenii
karnevál	karnevála
kategoria	kategoriija
kategoriaid	kategoriijaid
kategoriaidda	kategoriijaide
kiinnalaš	kiinnálaš
kinalaččaid	kiinnálaččaid
kinopremiere	kinopremieara
kirurgiijja	kirurgiija
klan	Klan
klasihkkalaš	klassihkalaš
klasihkkara	klassihkkára
klasihkkára	klassihkkára
klasihkkáriid	klassihkkáriid
klasihkkáriin	klassihkkáriin
klassihkkalaš	klassihkalaš
klassá	klássa
klassalanjaid	klássalanjaid
klistariidda	klisttariidda
kloakke	kloáhka
kloakkes	kloáhkas
kolloktiivageaseheapmi	kollektiivageaseheapmi
klostersierralobiŧ	klostersierralobit
klubbai	klubbii
klux	Klux
km2	km²
koarii	korrii
koarrii	korrii
kollektiivalaš	kollektiivvalaš
kollektiva	kollektiiva
komeanta	kommeanta
komenteret	kommenteret
komentáraid	kommentáraid
komentárat	kommentárat
kommentara	kommentára
komplementære	komplementára
kon-seartta	konseartta
konferanssa	konferánssa
konferanssas	konferánssas
konfermášuvdnii	konfirmašuvdnii
konferánasa	konferánsa
konferánsain	konferánssain
konferánssaig	konferánssaid
konfirmášuvnnat	konfirmašuvnnat
konsearttai	konsertii
konsentrašudvii	konsentrašuvdnii
konsešuvdnageatnegasvuodas	konsešuvdnageatnegasvuođas
kontorservice	Kontorservice
konulentii	konsulentii
konvenšuvnda	konvenšuvdna
konvešuvnna	konvenšuvnna
koordinahtor	koordináhtor
korajoavku	koarrajoavku
korrekuvraprográmma	korrekturprográmma
kr:uin	kr:iin
kreatiivalaččat	kreatiivvalaččat
kreatiivalaš	kreatiivvalaš
kreátiivvalaš	kreatiivvalaš
kriminallága	kriminálalága
kriminealla	kriminála
kristine	Kristine
kritihkkalaččat	kritihkalaččat
kritihkkalaš	kritihkalaš
kritihkkálaččat	kritihkalaččat
kritihkkálaš	kritihkalaš
kuffára	koaffara
kultivrii	kultuvrii
kulttorbálkášumi	kulturbálkkašumi
kulttorbálkášupmái	kulturbálkkašupmái
kultumuitolága	kulturmuitolága
kultumuitoláhka	kulturmuitoláhka
kultur	kultur-
kulturbálkášumi	kulturbálkkašumi
kulturbálkášupmi	kulturbálkkašupmi
kulturdepartementtii	kulturdepartementii
kulturfáladagaid	kulturfálaldagaid
kulturiesstivrejupmái	kulturiešstivrejupmái
kulturlonohus	kulturlonuhus
kulturministtarii	kulturministarii
kulturmuitorádi	kulturmuitoráđi
kulturmuitorádis	kulturmuitoráđis
kulturovdanbukima	kulturovdanbuktima
kulturpolitihkii	kulturpolitihkkii
kulturpolitihkkalaš	kulturpolitihkalaš
kulturpolitihkálaš	kulturpolitihkalaš
kulturrádi	kulturráđi
kulturskovla	kulturskuvla
kulturvii	kultuvrii
kulturvrra	kultuvrra
kultutmuitolága	kulturmuitolága
kultuviesuid	kulturviesuid
kultuvralaš	kultuvrralaš
kultuvrrai	kultuvrii
kultuvrraineasetguin	kultuvrraideasetguin
kultuvrrálaš	kultuvrralaš
kunddariidda	kundariidda
kunderat	kundarat
kunderiin	kundariin
kurša	kursa
kurššiide	kurssaide
kvadratmehtaris	kvadráhtamehteris
kveanasápmalaččat	kvenasápmelaččat
kvotaortnega	kvohtaortnega
kválitehta	kvalitehta
káfeja	kaféa
káfejás	kaféas
kákáo	kakáo
kámela	kamela
kánale	kanála
kánále	kanála
kápteaidna	kapteaidna
kárášjoga	Kárášjoga
kárášjogas	Kárášjogas
kárášjot	Kárášjoga
kátástrofa	katastrofa
káŋŋas	gátnos
l0	10
l00	100
l00.	100.
l000	1000
l000-rehkegin	1000-rehkegin
l@¡ga	lága
la	lea
lababui	lagabui
laboratiijaide	laboratoriaide
laboratora	laboratoria
laboratorat	laboratoriat
laddasa	lađđasa
laddasis	lađđasis
ladje	ládje
lagabot	lagabut
lagabuid	lagabui
lagamui	lagabui
lagan	lágan
lagasradio:idda	lagasradioide
lagi	lági
lagidit	lágidit
lagidivččii	lágidivččii
lagiin	lágiin
lagárievdeami	lágarievdadeami
lahkai	láhkai
lahkka	lahka
lahkkonišgoahtá	lahkonišgoahtá
lahkkosis	lahkosis
lahkosii	lahkosiidda
lahká	lahka
lahkái	láhkái
lahttendoaimmahaŧ	lahttendoaimmahat
lahttovuođašiehatadusa	lahttovuođašiehtadusa
lahttuguovttus	lahttuguovttos
lahttuguvttas	lahttuguovttos
lahttuid	láhttuid
lahttuide	láhttuide
lahttái	láhttái
lahtui	lahttui
laiguhit	láigohit
lantja	latnja
lasahus	lasáhus
lasahusa	lasáhusa
lasahusain	lasáhusain
lassana	lassána
lassaneami	lassáneami
lassaneapmi	lassáneapmi
lassanii	lassánii
lassanit	lassánit
lassiin	lassin
lassivaikkuhusat	lassiváikkuhusat
lasssin	lassin
lassánaan	lassánan
lassánán	lassánan
latenamerihkalaš	latenamerihkálaš
latinámeriikkalaš	latin-amerihkálaš
lavdnjegoađ	lavdnjegoađi
lave	láve
lavejit	lávejit
lavvu	lávvu
lašmmohallat	lášmmohallat
lašmohallanlatnja	lášmmohallanlatnja
leahkos	lehkos
leahttuin	leahtuin
leaikásii	leaikasii
leal	leat
leamin	leamen
leamáš	leamaš
leansmanbálvvat	leansmanbálvvát
leansmánnebálváide	leansmánnebálvváide
leavgastávrraide	leavgastávrráide
leavva	leavvá
leay	leai
leažža	leažžá
leažžago	leažžágo
leažžái	leaččai
leddje	ledje
leddjen	ledjen
lehtuin	leahtuin
leigge	leigga
leimma	leimme
lensmanbálvva	leansmanbálvvá
lensmanbálvvat	leansmanbálvvát
lensmankántuvrra	leansmankantuvrra
lensmanni	leansmánni
lestadalaš	lestadiánalaš
lestadialaš	lestadiánalaš
letnet	leat
letnot	leat
levdnjii	Levdnjii
lešgudet	iešguđet
lhkai	láhkái
lhkuhisvuođas	lihkuhisvuođas
lhábmemiidda	hábmemiidda
li	lei
libris	Libris
liekkusit	liggosit
lievvelis	lievvilis
ligo	iigo
lihkkastaga	lihkastaga
lihkkostuvvan	lihkostuvvan
lihkkostuvvat	lihkostuvvat
lihkomen	liikomen
lihkoshisvuođa	lihkohisvuođa
lihkostuvva	lihkostuvvá
lihkostuvvui	lihkostuvai
lihkulaš	lihkolaš
lihkustuvvui	lihkustuvai
lihkádišgohtet	lihkadišgohtet
lihtii	lihti
lihton	lihtton
lihttoláigolacca	lihttoláigolačča
lihtái	lihttái
liibbaidde	liibbaide
liiká	liikká
liinnii	liinni
linjja	linjjá
listtui	listui
listuin	listtuin
litnetselvánis	iešdieđáhusas
litnetšemaide	litnetšemáide
litná	litna
livcce	livčče
livccii	livččii
livkkehin	livkkihin
livkkehit	livkkihit
livnneteiseváldiide	livnneteiseválddiide
livzzavihki	livzávihki
livče	livčče
livčii	livččii
livččejit	livčče
livčči	livččii
livččiii	livččii
livččimet	livččiimet
loahpageahen	loahpageahčen
loahpahuvui	loahpahuvvui
loahpahuvvvon	loahpahuvvon
loahpajeddjiid	loahpaheddjiid
loahpalaccat	loahpalaččat
loahppačuokkislohku	loahppačuokkeslohku
loaččadet	loaččadit
lobalaččat	lobálaččat
lobalaš	lobálaš
lobalašvuođa	lobálašvuođa
lobalažžan	lobálažžan
loddejaddjit	loddejeaddjit
loddejeddjid	loddejeddjiid
loddevirusas	loddevirusis
loddiid	lottiid
logadallamis	logaldallamis
logadallat	logaldallat
logadalli	logaldalli
logadalliin	logaldalliin
logaldallamistis	logaldallamisttis
logenariid	logenáriid
logijahkásas	logijahkásaš
logái	logai
lohkká	lohká
lohknaválgastivrii	lohkanválgastivrii
lohkojuvvo	lohkkojuvvo
lohkágoahtit	lohkagoahtit
lohpadusaid	lohpádusaid
lohpaha	loahpaha
lohpet	lovpet
lohppida	lohpida
lohppidan	lohpidan
lohppidii	lohpidii
lohppidit	lohpidit
lohppit	lohpit
lohppádusastis	lohpádusastis
lojalitehttaruossalasvuođat	lojalitehtaruossalasvuođat
lojáliteahtta	lojaliteahtta
lokhkiide	lohkkiide
lonohit	lonuhit
losiidahttibehtet	losidahttibehtet
losiidahttit	losidahttit
lossimus	losimus
lotkatmeahttun	lotkkotmeahttun
lotnalasealáhusaid	lotnolasealáhusaid
lotnalassii	lotnolassii
lottibiepmu	loddebiepmu
lottideamet	lottiideamet
lottii	loddii
lottiratti	lotteratti
luhte	luhtte
luiohttevažžii	luohttevažžii
luitá	luoitá
lulabealde	lulábealde
lulas	lulás
lullebealla	lullebeallá
lullevuvddiide	lullivuvddiide
lulábeal	lulábealde
lummás	lummas
lunddolaccat	lunddolaččat
lunttáš	lunttaš
luohkaš	luohkáš
luohkkaráđi	luohkkáráđi
luohtamuš	luohttámuš
luohtamuša	luohttámuša
luohttamuš	luohttámuš
luohttamuša	luohttámuša
luohttehahtti	luohtehahtti
luoikká	luoiká
luoitigoahtet	luoitigoahtit
luonain	loanain
luonddat	lunttat
luonddolaččat	lunddolaččat
luonddolaš	lunddolaš
luonddubirásgáhttema	luonddubirasgáhttema
luonddugáhttensearrvi	luonddugáhttensearvi
luondduriggadagaid	luondduriggodagaid
luondduriggodaid	luondduriggodagaid
luonddutiipaide	luonddutiippaide
luondodoalu	luonddudoalu
luondohábmen	luondduhábmen
luopmaniid	luopmániid
luossanuohtiin	luossanuhtiin
luossačážádagaid	luossačázádagaid
luossobivdobáiki	luossabivdobáiki
lupmet	lubmet
luthera	Luthera
lutheránalaš	luhteránalaš
luvvešivčče	luvvešedje
luvvádan	luvvadan
lysningsblad	Lysningsblad
lysningsblađis	Lysningsbladas
lábmásat	lápmásat
lábmásiid	lápmásiid
láddagat	láttagat
láddagiid	láttagiid
láddeláččat	láddelaččat
ládjet	láddjet
ládjogittid	ládjogittiid
lágabui	lagabui
lágada	lágida
lágadus	lágádus
lágadusaid	lágádusaid
lágadusat	lágádusat
lágamus	lagamus
lágidanšiehtadusaŧ	lágidanšiehtadusat
lágidedjiin	lágideddjiin
lágiduvui	lágiduvvui
lágábuid	lagabui
lágáide	lágaide
láhcit	láhčit
láhča	láhčá
láhkaduopmostuluin	láhkaduopmostuoluin
láhkagirjjid	láhkagirjjiid
láhkariekteolbmáŧ	láhkariekteolbmát
láhkarievadusa	láhkarievdadusa
láhkarihkGon	láhkarihkkon
láhkavuodu	láhkavuođu
láhkavuoduin	láhkavuođuin
láhkonit	lahkonit
láhti	láhtti
láhtis	láhttis
láhttemiš	láhttemis
láhttuvuođa	lahttuvuođa
láhčat	láhčit
láibbiit	láibbiid
láiddomistis	láiddomisttis
láigogaskavuođaŧ	láigogaskavuođat
láigohanvuoigatvuoda	láigohanvuoigatvuođa
láigolacca	láigolačča
láigolihttoáigodaŧ	láigolihttoáigodat
láiguha	láigoha
láiguheapmi	láigoheapmi
láiguheapmái	láigoheapmái
láiguhit	láigohit
lásihuvvon	lasihuvvon
lássanit	lassánit
lássiváikuhusat	lassiváikkuhusat
lássánii	lassánii
láttieallimii	látteeallimii
láttiluondu	látteluondu
lávdefággá-dallama	lávdefággádallama
lávdegoddečoahkimat	lávdegoddečoahkkimat
lávdegottid	lávdegottiid
láved	láven
láviije	láveje
lávijeddje	lávejedje
lávijit	lávejit
lávllagat	lávlagat
lávostallemn	lávostallamin
lávvodradaga	lávvordaga
lávvárdaga	lávvardaga
lávžegeahčen	lávžegeažis
lášmmat	lášmat
ma..el	maŋŋel
ma..il	maŋŋil
ma..á	maŋŋá
maddái	maiddái
magihkkalaš	magihkalaš
mahcaheamen	máhcaheamen
mahcahit	máhcahit
mahcahuvvojit	máhcahuvvojit
mahccan	máhcan
mahccá	máhccá
mahccán	máhccán
mahka	mahká
mahkaš	mahkáš
mahtte	máhtte
maidde	maidda
maiddi	maiddái
maiddáid	maiddái
maidguin	maiguin
mailmmi	máilmmi
maimánus	máimánus
mainnašuvvo	máinnašuvvo
makkar	makkár
makkarge	makkárge
makkrge	makkárge
maksit	máksit
maksá	máksá
malistuvvo	málistuvvo
mangga	máŋgga
manjožassii	maŋážassii
manjásbahtii	maŋásbahtii
mannodaga	mánnodaga
mannágoahtá	mannagoahtá
mannálaš	mánnálaš
mannálaš:	mánnálaš:
maoriat	maorit
markkašumiide	mearkkašumiide
maskelaging	hámaidráhkadeapmi
massiimiidda	massimiidda
masttalmahtet	masttalmahttet
matematihkkár	matematihkar
materialat	materiálat
materialaš	materiálalaš
materialistalaš	materialisttalaš
materialstipeandda	materiálastipeandda
matriálalaš	materiálalaš
maursyra	gotkasivra
mavsse	mávsse
mađiiájaid	máđijaid
maŊimustá	maŋimustá
maŊŊá	maŋŋá
maŋabealde	maŋábealde
maŋga	máŋga
maŋge	mange
maŋgelágan	mangelágan
maŋgga	máŋgga
maŋggabealat	máŋggabealat
maŋggakultuvrralašvuođa	máŋggakultuvrralašvuođa
maŋggálágan	máŋggalágan
maŋilis	maŋŋelis
maŋius	maŋimus
maŋŋa	maŋŋá
maŋŋemus	maŋemus
maŋŋeseattii	maŋŋesehttii
maŋŋálágaid	maŋŋálagaid
mašenlogahahtti	mášenlogahahtti
meahcasteaddjiid	meahcásteddjiid
meahcasteami	meahcásteami
meahcasteapmái	meahcásteapmái
meahcce	meahcci
meahccedádjodeami	meahccedádjadeami
meahcceluoddaláhkaásahuš	meahcceluoddaláhkaásahus
meahccesteami	meahcásteami
meahccevalljiid	meahccevaljiid
meahcceveahkkebargikurššas	meahcceveahkkebargikurssas
meahccčái	meahccái
meahceallit	meahcieallit
meahcelliid	meahcielliid
meahciš	meahcis
meahcásteapmai	meahcásteapmái
meakkašupmi	mearkkašupmi
meannudandagaldumiŧ	meannudandagaldumit
meannudaproseassa	meannudanproseassa
meannudovvon	meannuduvvon
meannuduvui	meannuduvvui
mearabeal	mearabeale
mearabela	mearabeale
mearariikkii	mearariikii
mearekkaša	mearkkaša
mearkaša	mearkkaša
mearkašahtti	mearkkašahtti
mearkkašatti	mearkkašahtti
mearkkašeamiid	mearkkašemiid
mearkkašá	mearkkaša
mearradusa	mearrádusa
mearradusaide	mearrádusaide
mearragátiis	mearragáttis
mearrdeapmi	mearrideapmi
mearrekeahtes	mearritkeahtes
mearridanválddáláš	mearridanválddálaš
mearridanválldi	mearridanválddi
mearridiii	mearridii
mearridusaid	mearrádusaid
mearriduvo	mearriduvvo
mearriduvui	mearriduvvui
mearridán	mearridan
mearrri	mearri
mearrádusaŧ	mearrádusat
mearrádussi	mearrádussii
mearás	mearas
measat	measta
meatta	meattá
meattáhusaind	meattáhusaid
meađđimiid	meađđemiid
mediafáladaga	mediafálaldaga
mediaidde	mediaide
mediebearráigeahčču	mediabearráigeahčču
medieguovddáža	mediaguovddáža
mehcasdallamii	meahcástallamii
meieridjii	meieriijii
meieriiain	meieriijain
meilas	mielas
meilde	mielde
meksikanalaš	meksikánalaš
meluvdna	melovdna
meluvnna	melovnna
mendo	menddo
meningokokk	meningokokka
merkkaša	mearkkaša
merkkašumit	mearkkašumit
merkkašupmi	mearkkašupmi
merošteamiid	meroštemiid
metara	mehtera
metállaŧ	metállat
meárrádusain	mearrádusain
mi	mii
middjiide	midjiide
midjide	midjiide
midjiidda	midjiide
miediha	mieđiha
miedihit	mieđihit
miehttá	miehtá
mielaevttoŧ	mielaevttot
mieldddisbuktá	mielddisbuktá
mieldde	mielde
mielddis-buktá	mielddisbuktá
mielddisbukta	mielddisbuktá
mielddisttis	mielddis
mieldebargiid	mielbargiid
mieldebargit	mielbargit
mielderuhtaduvvon	mielruhtaduvvon
mieldisbuktá	mielddisbuktá
miellagiddevašat	miellagiddevaččat
miellahtto-vuohta	miellahttovuohta
miellahttoservviides	miellahttoservviidis
miellahttuid	miellahtuid
miellahttuin	miellahtuin
miellahttut	miellahtut
miellahtučoahkima	miellahtučoahkkima
miellačájeheamiŧ	miellačájeheamit
miellegiddevaš	miellagiddevaš
miellgiddevažžii	miellagiddevažžii
mielláhttuvuođa	miellahttovuođa
mien	min
miennudanvuogi	meannudanvuogi
mierka	mearka
miestamáddágii	miesttamáddagii
miettá	miehtá
mieáđiheamiin	mieđihemiin
mieđihuvui	mieđihuvvui
mieđihuvvoŧ	mieđihuvvot
mieđušteddjái	mieđušteaddjái
miha	mihá
mihke	mihkke
mihkege	mihkkege
mihttolávvai	mihttolávvái
mihtádusvuoigatvuodaid	mihtádusvuoigatvuođaid
mihtádusvuoigatvuodat	mihtádusvuoigatvuođat
miidjiide	midjiide
miiguin	minguin
miin	min
miirkobálvalusa	mirkobálvalusa
mijovnna	miljovnna
mildosin	mielddusin
milii	millii
milijuvdnii	miljovdnii
milijuvnna	miljovnna
militanta	militánta
militearbálvalusas	militearabálvalusas
militærfievrruid	militearafievrruid
miljardda	miljárdda
miljona	miljon
miljovnaid	miljovnnaid
miljovnno	miljovnna
miljovvna	miljovnna
miljuneara	miljoneara
miljuvdna	miljovdna
miljuvdnii	miljovdnii
miljuvnna	miljovnna
miljuvnnas	miljovnnas
milliarda	miljárda
milliardda	miljárdda
millijon	miljon
millijunearan	miljonearan
millijunhaddái	miljonhaddái
milliovnna	miljovnna
milliárda	miljárda
milliárdda	miljárdda
milljon	miljon
milljovnna	miljovnna
milljovnnaid	miljovnnaid
milljuneara	miljoneara
milljuvnna	miljovnna
minerálliiggiŧ	minerálaliiggit
minerálvuoigatvuodaid	minerálavuoigatvuođaid
minerálvuoigatvuodat	minerálavuoigatvuođat
ministtara	ministara
ministtarat	ministarat
ministtariid	ministariid
minsttariid	minstariid
minuvttasaš	minuktasaš
mišunbáhtii	miššunbáhti
mksit	máksit
moaddeloht	moaddelot
moaddečuohte	moaddečuohti
moadede	moadde
moaitágiid	moaitagiid
moarssi	moarsi
moarssis	moarsis
moatit	moaitit
moatte	moatti
mobilanjuovahagaid	mobiilanjuovahagaid
moddji	modji
modellaid	modeallaid
modjá	moddjá
mohkástit	mohkastit
moht	mot
mohtotjohtolatlágaid	mohtorjohtolatlágaid
moitii	moittii
mokte	moktege
moktá	mokta
molssašumi	molsašumi
molssašupmi	molsašupmi
molssoevttolaš	molssaevttolaš
monnebavtti	monnebávtti
morašii	morrašii
morideapmi	moriheapmi
moridit	morihit
morráná	morrána
morssiide	morsiide
motabiktasiid	motebiktasiid
motorkluppat	mohtorkluppat
motroralažžii	motoralažžii
movtiideami	movttiideami
movttaskit	movttáskit
movttege	moktege
movttida	movttiida
movttidahtán	movttiidahtán
movttideapmi	movttiideapmi
movttidit	movttiidit
movttidivčče	movttiidivčče
movttiidahtit	movttiidahttit
movttiidahttášii	movttiidahtášii
movttáskán	movttáskan
muddenfápmudusaŧ	muddenfápmudusat
muddenvuogádaŧ	muddenvuogádat
mudui	muđui
muhkiid	muhkkiid
muht	muhto
muhtehahtti	muhtihahtti
muhtiimiiguin	muhtimiiguin
muhtim	muhtin
muhtinat	muhtimat
muhtinlagan	muhtinlágan
muhtp	muhto
muhtu	muhto
muinne	munnje
muitaleamuš	muitaleamoš
muitalá	muitala
muitovuođđodus	muitovuođđudus
muittan	muittán
muittoha	muittuha
muittuihit	muittuhit
muitála	muitala
muitálus	muitalus
munje	munnje
munnuidda	munnuide
munnus	munnos
muohtaskohterreagaŧ	muohtaskohterreagat
muorjedatnjasat	muorjedakŋasat
muorjegivlmiin	muorjegilvimiin
muorra-dáida	muorradáidda
muorrasládja	muorrašládja
muorraávnnasgávpašeaddjiid	muorraávnnasgávppašeddjiid
muosahan	muosáhan
muosehuttimiid	muosehuhttimiid
muossá	muoŧŧá
muoŧŧa	muoŧŧá
musihkara	musihkkara
musihkarat	musihkkarat
musihkariid	musihkkariid
musihkáriin	musihkkáriin
musihkii	musihkkii
musihkkaelementtaid	musihkkaelemeanttaid
musihkkafeastiválai	musihkkafestiválii
musihkárat	musihkkárat
musihkáriid	musihkkáriid
musikalalaš	musihkalaš
mutnos	munnos
muttagis	muttágis
mutto	muttu
muttorfievrruiguin	mohtorfievrruiguin
muttorfievrruin	mohtorfievrruin
muttorjohtolat	muhtorjohtolat
muttorjohtolatlága	mohtorjohtolatlága
muttorjohtolatláhka	mohtorjohtolatláhka
mytologia	mytologiija
má-náidfestiválain	mánáidfestiválain
má.ga	máŋga
má.ggalágán	máŋggalágán
mádjihaŧ	mádjigat
mággabealát	máŋggabealat
máhcá	máhca
máhcástat	máhcastat
máhtolašuvohta	máhtolašvuohta
máhtolašuvođain	máhtolašvuođain
máhttajeddjiidisguin	máhttájeddjiidisguin
máhtuit	máhtuid
máhtet	máhttet
máibmái	máilbmái
máidege	maidege
máidnasit	máidnasiid
máiguin	maiguin
máilbme	máilmme
máilbmedássásaš	máilmmidássásaš
máilm-mis	máilmmis
máilmmes	máilmmis
máimmesoađi	máilmmisoađi
máimmis	máilmmis
máinnasmáilmmes	máinnasmáilmmis
máinnašveara	máinnašanveara
máinnosteavsttaid	máinnusteavsttaid
máistejin	máisten
mákkar	makkár
mákkarge	makkárge
mákkár	makkár
mákkárge	makkárge
máksa	máksá
máksimiida	máksimiidda
máktoštit	mátkkoštit
mállide	málliide
málmmi	máilmmi
málmmis	máilmmis
mánaid	mánáid
mánain	mánáin
mánga	máŋga
mángga	máŋgga
mánggafearggat	máŋggafearggat
mánggaid	máŋggaid
mánggain	máŋggain
mánggalágáš	máŋggalágáš
mánggalágáš:	máŋggalágáš:
mánggas	máŋggas
mánggat	máŋggat
mángii	máŋgii
mánjit	maŋit
mánnod.	mán
mánnáseanggas	mánnáseaŋggas
mánoheahpe	mánoheahpi
mánáidguin	mánáiguin
mánáidgárde	mánáidgárdi
mánáidruoktoášši	mánáidruovttuášši
mánáidsoadjalusa	mánáidsuodjalusa
mánáidsoadjalusas	mánáidsuodjalusas
mánáidsoadjalusbálvalusas	mánáidsuodjalusbálvalusas
mánáidsodjalusas	mánáidsuodjalusas
mánáigárddi	mánáidgárddi
mánáiskuvlla	mánáidskuvlla
máret	Máret
márfebuoieldit	márfebuoiddit
márkafievrredeapmi	márkanfievrredeapmi
márkanasttit	márkanastit
márkanfievredeapmái	márkanfievrredeapmái
márkanfievrredit	márkanfievrridit
márkanšiljui	márkanšilljui
márkanšilljus	márkanšiljus
márkasámit	márkosámit
márkkan	márkan
márkkes	márkkis
márreŧ	márret
márskku	márškku
márškkulaš	márškkolaš
mát	mat
mátkai	mátkái
mátkii	mátki
mátkiid	mátkkiid
mátkiide	mátkkiide
mátkiin	mátkkiin
mátkit	mátkkit
mátkkiinistis	mátkkiinis
mátkkošteamiin	mátkkoštemiin
mátkoštanealáhusa	mátkkoštanealáhusa
mátkoštit	mátkkoštit
máttabeal	máttabealde
máttá	mátta
máttárváhnemis	máttarváhnemis
máttásámi	máttasámi
mávssolaccat	mávssolaččat
máđe	mađe
máđiijá	máđija
máđiijáid	máđijaid
máŋemus	maŋemus
máŋemuš	maŋemuš
máŋgag	máŋgga
máŋgakultuvrralaš	máŋggakultuvrralaš
máŋgaloht	máŋgalot
máŋgalágan	máŋggalágan
máŋgačuohte	máŋgačuohti
máŋggabealaŧ	máŋggabealat
máŋggabealát	máŋggabealat
máŋggalágáan	máŋggalágán
máŋggasuoraŧ	máŋggasuorat
máŋggasuorggát	máŋggasuorggat
máŋgglágan	máŋggalágan
máŋggás	máŋggas
máŋggát	máŋgga
máŋgi	máŋgii
máŋiduvvon	maŋiduvvon
máŋimus	maŋimus
máŋimuš	maŋimuš
máŋŋebargga	maŋŋebárgga
máŋŋebárgga	maŋŋebárgga
máŋŋel	maŋŋel
máŋŋil	maŋŋil
máŋŋonan	maŋŋonan
máŋŋá	maŋŋá
mášuheapme	mášoheapme
n.g.	ng.
nade	nalde
nagirčalbmiid	nagirčalmmiid
nagodi	nagodii
nagudan	nagodan
nagudit	nagodit
nagut	nagot
nahkarat	nahkárat
nahkariid	nahkáriid
nahkkeseahka	náhkkeseahka
naittosguoimmis	náittosguoimmis
nalá	nala
namadeamis	nammadeamis
namakeahttá	namatkeahttá
namalasii	namalassii
namalassi	namalassii
namhuvvon	namahuvvon
nammadadan	nammadan
nammakonsu-leantabálvalusa	nammakonsuleantabálvalusa
nammamearkkaguin	nammamearkkaiguin
nammasas	nammasaš
nammidahkii	nammejahkii
nammá	namma
nammádeapmi	nammadeapmi
nammásaš	nammasaš
namuhasttet	namuhastit
namuhuvvodedje	namuhuvvojedje
namukeahttá	namutkeahttá
namáid	namaid
namás	namas
nannamii	nannámii
nannamis	nannámis
nannan	nannán
nannejiŧ	nannejit
nannesivččii	nannešii
nanneuvvo	nannejuvvo
narkitihkka	narkotihkka
narkotihkká	narkotihkka
nautálaš	nautalaš
navdan	navdán
navdii	navddii
navvala	navvála
našunala	našunála
našunalbeaivi	našunálabeaivi
našunálpárkavávtta	našunálapárkavávtta
našunálpárkka	našunálapárkka
našuvnda	našuvdna
neahttasiiduid	neahttasiidduid
neahttaáksiovnnas	neahttaakšuvnnas
neaktarat	neaktárat
nealge	nealgi
nealggušii	nelggošii
nealljejuvlla	njealjejuvllat
nearriduvvon	mearriduvvon
neavt-tár	neavttár
neavttar	neavttár
neavttarat	neavttárat
neavttariid	neavttáriid
neavttariidda	neavttáriidda
neavttariiguin	neavttáriiguin
neavui	neavvui
neavuide	neavvuide
nejalját	njealját
nenentsar	nenetsa
nguo	nugo
niedafearánat	nieidafearánat
niedda	nieidda
nieddaguovttos	nieiddaguovttos
nieddat	nieiddat
nieddaš	nieiddaš
niehkko	niehku
niehko	niehku
nieidaskihpariin	nieidaskihpáriin
nieidasáhpanat	nieidasáhpánat
nieiddážiin	nieiddažiin
nielddus	mielddus
nihkela	nihkkela
nihtojuvvo	nihttojuvvo
nihtá	nihttá
nii	nie
niibbii	niibbiid
nisonkonferansa	nisokonferánsa
nisosnolmmoš	nissonolmmoš
nissongávppošeapmi	nissongávppašeapmi
nissoniida	nissoniidda
nissoniiin	nissoniin
nissonkonferansa	nissonkonferánsa
nissonkonferánsaid	nissonkonferánssaid
nissonnat	nissonat
nissonolbmoid	nissonolbmuid
nissonolbmoin	nissonolbmuin
nissonstrategiijjat	nissonstrategiijat
nissuŧ	nissut
nit	maid
njahcu	njáhcu
njealastit	njielastit
njealjadaskilomehtera	njealjádaskilomehtera
njealje	njealji
njealjes	njealjis
njealječihkii	njeallječihkii
njealjje	njeallje
njealjji	njealji
njealjjis	njealjis
njealjját	njealját
njealjása	njealljása
njealjásis	njealljásis
njealljegoalmmatlohkái	njealljegoalmmátlohkái
njealljejahkásaš	njealjejahkásaš
njealljejahkáš	njealjejahkásaš
njealljejuolggat	njealjejuolggat
njeallji	njeallje
njealljii	njealji
njealljis	njealjis
njealljádas	njealjádas
njealljádasoassi	njealjádasoassi
njealljádin	njealjádin
njeallját	njealját
njieiga	njeaiga
njieđai	njiejai
njinnjelasat	njiŋŋelasat
njoarusteapmi	njoarosteapmi
njukcamánu	njukčamánu
njukčam.	njuk
njukčá	njukča
njukčámánu	njukčamánu
njunnušii	njunnošii
njunnužat	njunnošat
njunnužis	njunnošis
njunoš	njunuš
njunožat	njunnošat
njunožii	njunnošii
njunožis	njunnošis
njunužis	njunnošis
njuoggadusaid	njuolggadusaid
njuoggadusat	njuolggadusat
njuolggočiegagat	njuolggočiegat
njuolgguslaŧ	njuolgguslaš
njuolggádusaid	njuolggadusaid
njuolggádusat	njuolggadusat
njuonnožat	njunnošat
njuonnožis	njunnošis
njuonuš	njunuš
njuorostit	njoarostit
njuovžieabbon	njuovžileabbon
njuozibut	njoazibut
njurgogoahtá	njurgugoahtá
njáhka	njáhká
njálgat	njálggat
njálmmalaččat	njálmmálaččat
njálmmalaš	njálmmálaš
njálmmigeaži	njálmmegeaži
njálmái	njálbmái
njávkkasti	njávkkastii
noađđásit	noađđádit
nomada	nomáda
nomaliseret	normaliseret
norpmáiguin	norpmaiguin
nubbe	nubbi
nubbesadjásaš	nuppisadjásaš
nubbijođiheadjji	nubbijođiheaddji
nubbát	nuppát
nubhi	nubbi
nuohtiin	nuhtiin
nuolgga	njuolgga
nuondda-hallamiidda	nuonddahallamiidda
nuonddahuvvan	nuonddahuvvon
nuoraguin	nuoraiguin
nuoraidkonferanssas	nuoraidkonferánssas
nuoraidoaimmaid	nuoraiddoaimmaid
nuoraidpsykiáhtralaš	nuoraidpsykiátralaš
nuoraidpsyktiatralaš	nuoraidpsykiátralaš
nuoraiskuvla	nuoraidskuvla
nuoriad	nuoraid
nuorragándán	nuorragándan
nuorrasáhpaniid	nuorrasáhpániid
nuortalaččaŧ	nuortalaččat
nuorttabeal	nuorttabealde
nuppastuhttin	nuppástuhttin
nuppeloht	nuppelot
nuppeš	nuppes
nuppádaside	nuppádasaide
nuppástuhtinprográmma	nuppástuhttinprográmma
nuppástuhttema	nuppástuhttima
nuppástuhttenbálkká	nuppástuhttinbálkká
nuppástuhttenáiggis	nuppástuhttináiggis
nuppástuhttenáigi	nuppástuhttináigi
nuppšstuhttit	nuppástuhttit
nuvtta	nuvttá
nággogážaldat	nággogažaldat
nággubohciideaddji	nággobohciideaddji
nágodan	nagodan
nágodat	nagodat
nágodit	nagodit
nágot	nagot
nágudan	nagodan
nágut	nagot
náhkeha	nahkeha
náhkehii	nahkehii
náhkáriid	nahkáriid
náittusbeallelaš	náittosbeallelaš
náittusdilli	náittosdilli
náittusdillái	náittosdillái
náittusguoimmi	náittosguoimmi
náivvašii	návddašii
nákkuŧ	nákkut
nákčii	nákcii
nálaštuhttimii	náláštuhttimii
námuhit	namuhit
nástiid	násttiid
nástit	násttit
náttusdili	náittosdili
návccáiguin	návccaiguin
náveta	náveha
návsto	návstu
návččaid	návccaid
nášunala	našunála
náššunála	našunála
oaccun	oaččun
oadnit	oaidnit
oaffaruššujuvvojit	oaffaruššojuvvojit
oaffárat	oaffarat
oaffáriidda	oaffariidda
oahhpogirjjiid	oahppogirjjiid
oahpahalleáigodaga	oahpahalliáigodaga
oahpaheaddjioahpahussi	oahpaheaddjioahpahussii
oahpaheddjin	oahpaheddjiin
oahpaheddjit	oahpaheaddjit
oahpahusfáladagain	oahpahusfálaldagain
oahpahusráđđai	oahpahusráđđái
oahpahussi	oahpahussii
oahpait	oahpahit
oahpi	oahppi
oahppaheaddji	oahpaheaddji
oahppahusgeatnegas	oahpahusgeatnegas
oahppasiin	oahppásiin
oahppes	oahpes
oahppid	ohppiid
oahppmii	oahppamii
oahppmiidda	oahppamiidda
oahppn	oahppan
oahppofáladagaid	oahppofálaldagaid
oahppogirjiid	oahppogirjjiid
oahppogirjiin	oahppogirjin
oahppogirjjid	oahppogirjjiid
oahppogirjjii	oahppogirjji
oahppogáibadusas	oahppogáibádusas
oahpponeavvo-ráhkadeapmai	oahpponeavvoráhkadeapmái
oahppoplánajovkkuide	oahppoplánajoavkkuide
oahppui	ohppui
oahppuin	oahpuin
oahppásmuvvat	oahpásmuvvat
oahppásmuvvet	oahpásmuvvet
oahppásnuvvat	oahpásnuvvat
oahppášmuvvat	oahpásmuvvat
oahpá-snuvvat	oahpásnuvvat
oahpáhusa	oahpahusa
oahpáhuslága	oahpahuslága
oahpásat	oahppásat
oaidnan	oaidnán
oaidne	oidne
oaidnitmeahttun	oaidnemeahttun
oainnan	oainnán
oainnasmahttimii	oainnusmahttimii
oainnasmahttimiidda	oainnusmahttimiidda
oainnide	oainnuide
oainnudeaset	oainnuideaset
oainnuigun	oainnuiguin
oainnuiid	oainnuid
oaive	oaivi
oaivegavpot	oaivegávpot
oaivilda	oaivvilda
oaivildii	oaivvildii
oaiviliiddaset	oaiviliiddiset
oaiviliiddat	oaiviliiddát
oaiviliiddeset	oaiviliiddiset
oaiviliidiset	oaiviliiddiset
oaivvila	oaivvilda
oaivvildeje	oaivvildedje
oaivvilduvvoi	oaivvilduvvui
oaivvildá	oaivvilda
oaivvilidit	oaivvildit
oaivvilidt	oaivvildit
oaivváhuvvan	oaivvahuvvon
oajppat	oahppat
oalat	oalát
oallatge	oallátge
oaluldávtti	oaloldávtti
oalái	oalgái
oamastabvuoigatvuohta	oamastanvuoigatvuohta
oamastanvuogádaŧ	oamastanvuogádat
oamastavuoigatvuohta	oamastanvuoigatvuohta
oamasteddji	oamasteaddji
oamstit	oamastit
oamástit	oamastit
oaneduvvon	oaniduvvon
oanehaccat	oanehaččat
oanehaččaŧ	oanehaččat
oanehisšilljogirdimaŧ	oanehisšilljogirdimat
oanehot	oanehut
oanehččat	oanehaččat
oapmáhaččaiguin	oapmahaččaiguin
oapponeavvoguovddážis	oahpponeavvoguovddážis
oapponeavvuid	oahpponeavvuid
oarje	oarjji
oarjeafriikka	Oarje-Afrihkká
oarjjabeal	oarjjabealde
oarjje	oarjji
oasitit	oastit
oassalastit	oassálastit
oasseaiggepolitihkkarat	oasseáigepolitihkkárat
oasseaiggepolitihkkariin	oasseáigepolitihkkáriin
oassemáhtolaš-vuohta	oassemáhtolašvuohta
oasseruhtadeamiiguin	oasseruhtademiiguin
oassesáigepolitihkkáriid	oasseáigepolitihkkáriid
oassálastan	oassálastán
oassálastejit	oassálastet
oassálastii	oassálasttii
oassálatit	oassálastit
oastan	oastán
oaste	oste
oastinovdavuoigatvuodas	oastinovdavuoigatvuođas
oasálastejit	oassálastet
oasálastii	oassálasttii
oasálastteje	oasálaste
oasálasttejit	oasálastet
oasálastten	oasálasten
oasálasttet	oassálastet
oasálasttit	oassálastit
oasálaččaguin	oasálaččaiguin
oat	Dat
oavdomearkkaiguin	ovdamearkkaiguin
oavvilda	oaivvilda
oavvildit	oaivvildit
oazzu	oažžu
oazzut	oažžut
oaččon	oaččun
oaččoše	oččoše
oaččošedje	oččošedje
oaččošeimmet	oččošeimmet
oaččošii	oččošii
oaččuiiga	oaččuiga
oaččušii	oččošii
oađđemin	oađđimin
oažžui	oaččui
oažžumus	oažžumis
obalaččat	oppalaččat
obalaš	oppalaš
obanassige	obanassiige
obanassinge	obanassiige
obá	oba
ocadit	ozadit
ochan	ohcan
odastuvvojedje	ođastuvvojedje
odda	ođđa
oddajagisartni	ođđajagisártni
oddamállet	ođđamállet
oddasis	ođđasis
odná	otná
odoaibmaortnega	doaibmaortnega
ohcakeahttá	ozakeahttá
ohcanaigemearri	ohcanáigemearri
ohcanvuoigatvuoda	ohcanvuoigatvuođa
ohccala	ohcala
ohccat	ohcat
ohcct	ohcat
ohci	ohcci
ohcmaiid	ohcamiid
ohcán	ohcan
ohkiin	ogiin
ohppihii	ohpihii
ohppiidjoavkui	ohppiidjovkui
ohppoplána	oahppoplána
ohppováillat	oahppováillat
oiannestit	oainnestit
oidejupmi	oidojupmi
oidnisis	oidnosis
oidnossii	oidnosii
oidnu	oaidnu
oinii	oinnii
oinnimet	oinniimet
oitta	gitta
okatge	oktage
okatvuođas	oktavuođas
okta-vuođas	oktavuođas
oktain	oktan
oktanasa	oktanaga
oktasaaš	oktasaš
oktasaccat	oktasaččat
oktasgaslaš	oktagaslaš
oktavuiođas	oktavuođas
oktavuoa	oktavuođa
oktavuoda	oktavuođa
oktavuodain	oktavuođain
oktavuodas	oktavuođas
oktavuođaš	oktavuođas
oktašas	oktasaš
okti	oktii
oktibuot	oktiibuot
oktigait	oktiigait
oktiibidjankeahttá	oktiibijakeahttá
oktiibut	oktiibuot
oktiilaččat	oktilaččat
oktiilašvuohta	oktilašvuohta
oktilas	oktilaš
oktovuoigatvuoda	oktovuoigatvuođa
oktovuoigatvuođ	oktovuoigatvuođa
olamearis	olámearis
olamuddui	olámuddui
olamuttos	olámuttos
olamuttus	olámuttos
olbma	olbmá
olbmaiguin	olbmáiguin
olbmat	olbmát
olbmoid	olbmuid
olbmoide	olbmuide
olbmoiguin	olbmuiguin
olbmoin	olbmuin
olbmoŧ	olbmot
olbmu	olbmo
olbmut	olbmot
olg-gut	olggut
olges	olgeš
olggosguvlui	olggošguvlui
olggošit	olgguštit
olggoštuvvojit	olgguštuvvojit
olggubealde	olggobealde
olgo	olgu
olgobeal	olggobealde
olgonastin	olgunastin
olgoriikkii	olgoriikii
olgoriikklalaččat	olgoriikkalaččat
olgoritministarii	olgoriikaministarii
olgortiministtar	olgoriikaministtar
olgos	olggos
olgosgollun	olggosgollun
olhmot	olbmot
oliislaš	ollislaš
olislaččat	ollislaččat
olitiijáin	politiijain
oljo	olju
ollasii	ollásii
ollasit	ollásit
ollašuvva	ollašuvvá
ollašuhttujuvvon	ollašuhttojuvvon
ollgooaidnit	olggosoaidnit
ollilaš	ollislaš
ollisalašvuođa	ollislašvuođa
ollislaccat	ollislaččat
ollislas	ollislaš
ollisolaččaide	ollislaččaide
ollju	olju
ollogat	ollugat
ollosii	ollosiid
ollusa	ollosat
ollásuvvojit	ollašuvvet
ollášuhttiimet	ollašuhtiimet
ollášuvvan	ollašuvvan
ollášuvvat	ollašuvvat
ollášuvvon	ollašuvvan
ollášuvvá	ollašuvvá
olmmai	olmmái
olmmos	olmmoš
olmmosšlažžii	olmmošlažžii
olmmošvuoigaid	olmmošvuoigatvuođaid
olmmáivákki	Olmmáivákki
olympijameašttirin	olympiijameašttirin
oláhusa	olahusa
oposišuvdna	opposišuvdna
oposišuvnnas	opposišuvnnas
oppa-nassiige	oppanassiige
oppaaide	oppalaččaide
oppalaccat	oppalaččat
oppalašvuoda	oppalašvuođa
oppažžii	oppalažžii
opplaččat	oppalaččat
orange	oránša
orangeruoššat	oránšaruoššat
ordnejuvvun	ordnejuvvon
orgaisašuvnnain	organisašuvnnain
organisatoraláš	organisatuvrralaš
organisatuvralaš	organisatuvrralaš
organiserejuvvoi	organiserejuvvui
organiserjuvvon	organiserejuvvon
organiseremistis	organiseremisttis
organisášuvnnas	organisašuvnnas
orginála	originála
orginálteavsttaid	originálateavsttaid
orgán	orgána
orgániserema	organiserema
orrugoahtet	orrugoahtit
orrundoarja	orrundoarjja
ortnetgat	ortnegat
ortneŧ	ortnet
oskGon	oskon
oskkudet	oskodet
oskkumušealliid	oskumušelliid
oskkáldasaŧ	oskkáldasat
oskugodii	oskugođii
oskáldasmeahttumis	oskkáldasmeahttumis
oskáldasmeahttun	oskkáldasmeahttun
ossudat	ossodat
ostte	oste
otna	otná
ovaolmmoš	ovdaolmmoš
ovda	ovdal
ovdagiitii	ovdagihtii
ovdagottilanjas	ovdagoddelanjas
ovdalgiitii	ovddalgihtii
ovdalot	ovttalot
ovdaláigohiŧ	ovdaláigohit
ovdamanniŧ	ovdamannit
ovdan-buktinbáikin	ovdanbuktinbáikin
ovdan-buktinhápmi	ovdanbuktinhápmi
ovdan-buktá	ovdanbuktá
ovdanan	ovdánan
ovdanbuktimistis	ovdanbuktimisttis
ovdaneami	ovdáneami
ovdaneamis	ovdáneamis
ovdaneapmi	ovdáneapmi
ovdaneapmái	ovdáneapmái
ovdanit	ovdánit
ovdda	ovtta
ovddabeal	ovddabealde
ovddadusbellodaga	ovddádusbellodaga
ovddadusbellodat	ovddádusbellodat
ovddalgihti	ovddalgihtii
ovddamearka	ovdamearka
ovddasdeaddji	ovddasteaddji
ovddasdeaddjit	ovddasteaddjit
ovddasteddji	ovddasteaddji
ovddasvastádus	ovddasvástádus
ovddasvstdus	ovddasvástádus
ovddasvástadus	ovddasvástádus
ovddasvástadusa	ovddasvástádusa
ovddasvástadusas	ovddasvástádusas
ovddavástideaddji	ovddasvástideaddji
ovddavástádus	ovddasvástádus
ovddavástádusa	ovddasvástádusa
ovdddas	ovddas
ovddemusát	ovddemusat
ovddes	ovddeš
ovddesáigái	ovddešáigái
ovddidanfaonda	ovddidanfoanda
ovddidanprográmmid	ovddidanprográmmaid
ovddideapmai	ovddideapmái
ovddidt	ovddidit
ovddiid	ovttiid
ovdditit	ovddidit
ovddásvástádus	ovddasvástádus
ovddáneapmai	ovdáneapmái
ovdideami	ovddideami
ovdidit	ovddidit
ovdinbuktin	ovdanbuktin
ovdál	ovdal
ovdánahtašii	ovdánahtášii
ovdánahttemis	ovdánahttimis
ovdánboahtá	ovdanboahtá
ovdáneamiin	ovdánemiin
ovdáná	ovdána
ovdánán	ovdánan
ovgagihtii	ovdagihtii
ovtatstallama	ovttastallama
ovttabealálaččaŧ	ovttabealálaččat
ovttadássasaš	ovttadássásaš
ovttajienalaccat	ovttajienalaččat
ovttakas	ovttaskas
ovttamano	ovttatmano
ovttamáno	ovttatmano
ovttaráđalašvuođa	ovttaráđálašvuođa
ovttasbargguommit	ovttasbargoguoimmit
ovttasbargojulggáštus	ovttasbargojulggaštus
ovttasbargošiehttadusa	ovttasbargošiehtadusa
ovttasbargošiehttadusas	ovttasbargošiehtadusas
ovttasbárgojoavku	ovttasbargojoavku
ovttasdahttojuvvon	ovttastahttojuvvon
ovttasdus	ovttastus
ovttasdusain	ovttastusain
ovttaskaš	ovttaskas
ovttasráđii	ovttasráđiid
ovttastahttášii	ovttastahtášii
ovttastusii	ovttastussii
ovttasvástadus	ovddasvástádus
ovttasvástolaš	ovddasvásttolaš
ovttatmanot	ovttatmano
ovttatmáno	ovttatmano
ovttárvosašvuohta	ovttaárvosašvuohta
ozolacca	ozolačča
ozolaccat	ozolaččat
ozovuoigatvuoda	ozovuoigatvuođa
ozovuoigatvuodabáktelága	ozovuoigatvuođabáktelága
ozovuoigatvuodas	ozovuoigatvuođas
oččo	ožžo
oččon	ožžon
oččosedje	oččošedje
oččui	oaččui
ođđasmahttit	ođasmahttit
ođasmahttan	ođasmahttán
ođasmahtteje	ođasmahtte
ođasmahttojuvui	ođasmahttojuvvui
ođastiŧ	ođastit
ođđ	ođđa
ođđamallet	ođđamállet
ođđastit	ođastit
ođđaáigasaš	ođđaáigásaš
ođđaáigáhaš	ođđaáigásaš
ođđá	ođđa
ođđáigásaš	ođđaáigásaš
ožas	ozas
ožžun	oažžun
ožžut	oažžut
palestiinalaš	palestinalaš
panser	pánser
paragrafa	paragráfa
paragráf	paragráfa
paralealla	parallealla
parlameantaralaš	parlamentáralaš
parlamentarálaš	parlamentáralaš
parlamenta	parlameanta
parlamentalaš	parlamentáralaš
parlamentta	parlameantta
parlamentárlaš	parlamentáralaš
pasiiva	passiiva
patriarkalaš	patriarkálalaš
pavagirku	poavagirku
pearšuvnnalaččat	persovnnalaččat
pedagoda	pedagoga
pedogogalaš	pedagogalaš
penna	peanna
pensjonista	penšunista
penšonista	penšunista
penšonkássat	penšunkássat
penšonkássii	penšunkássii
penšonvuoigatvuođaid	penšunvuoigatvuođaid
penšouproseantta	penšunproseantta
persepšudvii	persepšuvdnii
personálstivrra	personálastivrra
persovnnalaccat	persovnnalaččat
peršonalgiehtagiehtagirjji	personálagiehtagirjji
peršuvdnálaččat	persovnnalaččat
peršuvnnalas	persovnnalaš
pingvina	pingviidna
pinniidemiid	biinnidemiid
pinniidit	biinnidit
plakátat	plakáhtat
plana	plána
planejuvvo	plánejuvvo
planejuvvujit	plánejuvvojit
plastihkkalottid	plastihkkalottiid
platinaskearru	platiidnaskearru
pleksaglássa	pleksiglássa
plánaevttuhusas	plánaevttohusas
plánai	plánii
plánenjuvvon	plánejuvvon
pláná	plána
plástihka	plastihka
plástihkka	plastihkka
poastagoartain	poastagoarttain
poastajournala	poastajournála
polara	polára
poliiijáin	politiijain
poliijaid	politiijaid
polisiijaid	politiijaid
polithkalaš	politihkalaš
politiadvokáhtta	politiijaadvokáhta
politiat	politiijat
politihkaláš	politihkalaš
politihkarat	politihkkarat
politihkariid	politihkkariid
politihkariidda	politihkkariidda
politihkariin	politihkkariin
politihkkálačat	politihkalaččat
politihkkálaččat	politihkalaččat
politihkkálaš	politihkalaš
politihklaš	politihkalaš
politiiat	politiijat
politiiija	politiija
politijaduođaštusa	politiijaduođaštusa
politijaide	politiijaide
politijat	politiijat
politijját	politiijat
politijáide	politiijaide
politiját	politiijat
polotiijat	politiijat
poltihkalaš	politihkalaš
poltihkkalaš	politihkalaš
poltihkkálaš	politihkalaš
poltiijat	politiijat
pornográfiija	pornografiija
porsáŋgolaččat	porsáŋgulaččat
poršeavttas	prošeavttas
positiivlaš	positiivvalaš
positivva	positiivva
postiivvalaš	positiivvalaš
potihkkasurggiid	politihkkasurggiid
praktihkkalaččat	praktihkalaččat
praktihkkalaš	praktihkalaš
praktihkkálaš	praktihkalaš
praktihkálaš	praktihkalaš
prágmahtalaš	pragmáhtalaš
práktihkkárii	praktihkkárii
práktihkkáris	praktihkkáris
preassadieđahusas	preassadieđáhusas
presensa	preseansa
presidaenta	presideanta
presideanttad	presideanttaid
presideantái	presidentii
presidenta	presideanta
presidentta	presideantta
pressedieđáhusastis	preassadieđáhusastis
prihsihppa-dieđáhusaid	prinsihppadieđáhusaid
prinisihpa	prinsihpa
prisihpaid	prinsihpaid
prisihpas	prinsihpas
privahta	priváhta
privahtaskuvllaid	priváhtaskuvllaid
priváhtarievttalaš	priváhtarievttálaš
proavas	proavás
proavassuohkana	proavássuohkana
proavasvirgái	proavásvirgái
proavásin	proavástin
produsenttaid	produseanttaid
produserensistema	produserensystema
profeassor	professor
profesjonealla	profeššunealla
professoras	professoris
profešonealla	profeššunealla
profila	profiila
programma	prográmma
programmaid	prográmmaid
programmas	prográmmas
progámma	prográmma
progámmas	prográmmas
promillegilvvu	promillagilvvu
promilleiskan	promillaiskan
propaganda	propagánda
propagándai	propagándii
proseaktajođiheaddji	prošeaktajođiheaddji
proseantalaš	proseanttalaš
proseassalahkaaddimis	proseassaláhkaaddimis
proseavtta	prošeavtta
prosetalaš	proseanttalaš
prospekterenossodaŧ	prospekterenossodat
prošavttat	prošeavttat
prošeaktaruhtadeamiin	prošeaktaruhtademiin
prošeattain	prošeavttain
prošeaktii	prošektii
prámaŧ	prámat
psykiatralaš	psykiátralaš
psykiatrálaš	psykiátralaš
psykiáhtralaš	psykiátralaš
psyklologaoahpu	psykologaoahpu
psyklologiija	psykologiija
psykologijii	psykologiijii
psykologálaš	psykologalaš
pumpežii	pumpešii
pussestalla	pussestallá
páhkkejuvovn	páhkkejuvvon
páhkká	páhkka
páhká	páhka
páhkáid	páhkaid
páhkás	páhkas
párasihtaid	parasihtaid
rabahttaortnegiid	rabáhttaortnegiid
rabies	rábies
radioa	rádio
radiokánale	radiokanála
radisáddagiid	radiosáddagiid
radjai	rádjái
radjet	rádjet
radjái	rádjái
rahkaduvvon	ráhkaduvvon
rahkaduvvot	ráhkaduvvot
rahkkanemiid	ráhkkanemiid
rahkkanišgoahtá	ráhkkanišgoahtá
rahpa	rahpá
rahpana	rahpasa
rahpojuvvo	rahppojuvvo
rahppan	rahpan
rahppá	ráhppá
rahpui	rahppui
rahpámiin	rahpamiin
rahčámuš	rahčamuš
raidu	ráidu
raigi	ráigi
raje	ráje
rajes	rájes
raji	ráji
ransáhket	ránsáhket
rasistalaš	rasisttalaš
rasistalažžan	rasisttalažžan
rasta	rastá
rastideaddji	rasttideaddji
rastideaddjái	rasttideaddjái
rastideddjiide	rasttideddjiide
rastilda	rasttilda
rastildeaddji	rasttildeaddji
rastildit	rasttildit
ratifikašuvngažaldat	ratifikašuvdnagažaldat
ravisolbmuid	rávesolbmuid
rađiiduvvot	ráđiiduvvot
raŋgaštemi	ráŋggášteami
reabbaealliŧ	reabbáeallit
reabbáid	reappáid
readjai	rádjái
readjái	rádjái
reahkaid	reahkáid
reahkkaid	reahkáid
reainnarat	reainnárat
reajes	rájes
realgelbbolašvuohta	reálagelbbolašvuohta
realgelbbolašvuođa	reálagelbbolašvuođa
reanga	reaŋga
reangan	reaŋgan
reanggat	reaŋggat
reat	leat
reavččagit	reavžžagit
reaškihit	reaškkihit
referansajoavkku	referánsajoavkku
refoarbma	reforbma
regias	regiijas
regiondepartemeantii	regiondepartementii
regiovdnapolitihkkalaš	regiovdnapolitihkalaš
regiovnnalaccat	regiovnnalaččat
registerejuvvon	registrerejuvvon
registeren	registreren
registrerjuvvot	registrerejuvvot
registtara	registara
registtariid	registariid
registtariidda	registariidda
rehkanastit	rehkenastit
rehkanastá	rehkenastá
rehkedoalujagi	rehketdoallojagi
rehkedoalus	rehketdoalus
rehkedollui	rehketdollui
rehkenastan	rehkenastán
rehkenastejit	rehkenastet
rehkenastejuvvon	rehkenastojuvvon
rehkenasttojuvvo	rehkenastojuvvo
rehkenástimis	rehkenastimis
rehketdoallo	rehketdoallu
rehketgirjjiŧ	rehketgirjjit
reiviid	reivviid
rekakšvudnan	reakšuvdnan
rekonstrukšudvii	rekonstrukšuvdnii
rekor	rektor
rektuteret	rekruteret
relavánta	relevánta
religiovdahistorjá	religiovdnahistorjá
religuvnnalaš	religiuvnnalaš
repertoaras	repertoáras
reportarat	reportárat
reportaša	reportáša
reportoára	reportára
reporttar	reportár
rertejit	fertejit
resturáŋŋa	restoráŋŋa
resturáŋŋas	restoráŋŋas
resursssaid	resurssaid
resurššaid	resurssaid
resurššat	resurssat
reákšuvnnaid	reakšuvnnaid
reákšuvnnat	reakšuvnnat
reškii	reškkii
rhkadit	ráhkadit
riavddai	rievddai
ribáhit	ribahit
riddo	riddu
ridduguovlu	riddoguovlu
riegadan	riegádan
riegadanbeaivi	riegádanbeaivi
riegadii	riegádii
riegeara	rigeara
riegádahttejit	riegádahttet
riegádattán	riegádahttán
rieiddut	reaiddut
riekteipmádusaid	riekteipmárdusaid
riektenjuolggadusaŧ	riektenjuolggadusat
riekteoahppavaččaŧ	riekteoahppavaččat
riekteoainnuŧ	riekteoainnut
riektevuogádaŧ	riektevuogádat
rievadadusaid	rievdadusaid
rievadit	rievdadit
rievda	rievdá
rievdakeahttá	rievdatkeahttá
rievdeami	rievdadeami
rievdii	rievidii
rievsahiid	rievssahiid
rievssagárddii	rievssatgárddiid
rievssatnjuovvanin	rievssatnjuovvamin
rievttilaš	rievttálaš
rievttioiainnu	rievttioainnu
riggodahkkii	riggodahkii
rihkkomeahttumis	rihkkumeahttumis
rihkkomeahttun	rihkkumeahttun
rihkušii	rihkošii
rihpestit	rihpastit
rihčagii	rihččagii
riiddudet	riiddodet
riidogážaldat	riidogažaldat
riiduid	riidduid
riiggáseamos	riggámus
riiissaid	riissaid
riikačoahkkamii	riikačoahkkimii
riikačoahkkims	riikačoahkkimis
riikkaidgaskasáš	riikkaidgaskasaš
riikkaoasilávdegotti	riikkaoasselávdegotti
riikkačoahkkimi	riikačoahkkimii
riikkii	riikii
riikkis	rikkis
rikkaidgaskasaš	riikkaidgaskasaš
rikkástuvvat	rikkustuvvat
ringestan	riŋgestan
ringet	riŋget
rislareahka	risláreahka
rissagárit	riššagárit
risteatnái	risteadnái
rittubeal	rittubeale
rivadit	ribadit
rivdadit	rievdadit
rivssatbivdu	rievssatbivdu
rivttit	rivttiid
rivveŧ	rivvet
rjes	rájes
roahkkatvuodain	roahkkatvuođain
roankasat	roaŋkasat
roankesuorpmaiguin	roaŋkesuorpmaiguin
roankečielgi	roaŋkečielgi
roasmahuvai	roasmmehuvai
roasmmahuvai	roasmmehuvai
roasmmahuvvan	roasmmehuvvan
roasmmahuvvat	roasmmehuvvat
roasmmahuvvon	roasmmohuvvon
roasmmehumiid	roasmmehuvvamiid
roavvarávddiŧ	roavvarávddit
rockar	rockár
rockarat	rockárat
rogganvuoigatvuoda	rogganvuoigatvuođa
rohkkaha	rohkkáha
rohkkahan	rohkkáhan
rohkkahii	rohkkáhii
rohkkahit	rohkkáhit
rohkosvisui	rohkosvissui
rohtii	rohttii
rohttodávddain	rohttudávddain
rohttášuvvan	rohttašuvvan
rokkáhit	rohkkáhit
rokkástit	rokkastit
rolfFa	rOlfFa
rollai	rollii
rollá	rolla
romantihkkalaš	romantihkalaš
romantihkkalažžan	romantihkalažžan
romssas	Romssas
romáhat	románat
romántalaš	románttalaš
ruda	ruđa
rudaid	ruđaid
rudalaš	ruđalaš
rudat	ruđat
ruhtadeamiid	ruhtademiid
ruhtagažu	ruhtagáhču
ruhtalaš	ruđalaš
ruhtaveahkái	ruhtaveahkkái
ruhtta	ruhta
ruhttadoarjaga	ruhtadoarjaga
ruhttagáldo	ruhtagáldo
ruhttajuolludeami	ruhtajuolludeami
ruhttaservvodahkki	ruhtaservvodahkii
rukses-ruona	rukses-ruoná
ruktobiillaŧ	ruktobiillat
rumašrihkosiidda	rumašrihkkosiidda
runasárgumaŧ	runasárgumat
rundearpmi	rundierbmása
ruoddi	ruođđi
ruoktoluotta	ruovttoluotta
ruona	ruoná
ruota	ruoŧa
ruovde	ruovdi
ruovdebáisttu	ruovdebáistte
ruovttušiljjus	ruovttušiljus
ruoškkaš	ruoškkas
ruošui	ruosui
ruoŧelaččaid	ruoŧŧelaččaid
ruoŧelaččaide	ruoŧŧelaččaide
ruoŧelaččat	ruoŧŧelaččat
ruoŧelaš	ruoŧŧelaš
rustega	rusttega
rutnoŧ	rutnot
ruvdkedoamma	ruvkedoaimma
ruvdnusaš	ruvdnosaš
ruvndui	ruvdnui
ruvnui	ruvdnui
ruvnnoin	ruvnnuin
ruvttubáikkivuoigatvuohta	ruovttubáikkivuoigatvuohta
ruškessáhpanat	ruškessáhpánat
rvudnui	ruvdnui
rábmadiibmolohku	rápmadiibmolohku
ráddádallá	ráđđádallá
rádi	ráđi
rádiide	ráđiide
rádja	rádjá
rádjaguovllulaš	rádjaguvllolaš
rádjejuvvon	ráddjejuvvon
rádjerastildeaddji	rádjerasttildeaddji
rádjusa	rádjosa
rádđehusa	ráđđehusa
ráfaiduhttima	ráfáiduhttima
ráfaiduhtton	ráfáiduhtton
ráfaleabbo	ráfáleabbo
ráfáidáhtton	ráfáidahtton
ráhkadasttit	ráhkadastit
ráhkadišgđii	ráhkadišgođii
ráhkadun	ráhkaduvvon
ráhkana	ráhkkana
ráhkanan	ráhkkanan
ráhkanit	rahkánit
ráhkdadit	ráhkadit
ráhkkanahttun	ráhkkanahttin
ráhkkásiinnat	ráhkkásiinnát
ráhklada	ráhkada
ráhkádit	ráhkadit
ráhppo	rahppo
ráhppojit	rahppojit
ráhčen	rahčen
ráhčá	rahčá
rájaid	rájáid
rájusgiddegassii	rájusgiddagassii
rámbuvrai	rámbuvrái
rámbuvrrin	rámbuvrriin
rámmajuolludeamiŧ	rámmajuolludeamit
rámmá	rámma
rámppui	rámpui
rámppástallet	rámppastallet
rámáadusaide	rámádusaide
ránggáštus	ráŋggáštus
ránggáštuvvot	ráŋggáštuvvot
ránnjáriikkii	ránnjáriikii
rápmadoarja	rápmadoarjja
rápmaid	rápmáid
ráskke	ráske
rátjái	rádjái
rávdnjefievrredeaddjiŧ	rávdnjefievrredeaddjit
rávesolbuin	rávesolbmuin
rávggoš	rávgoš
rávisolbuid	rávesolbmuid
ráđid	ráđiid
ráđđadallangoddi	ráđđádallangoddi
ráđđadallangotti	ráđđádallangotti
ráđđadallangottis	ráđđádallangottis
ráđđadallangottti	ráđđádallangotti
ráđđedagadagaide	ráđđedagadiidda
ráđđedagadahkii	ráđđedagadii
ráđđehusadvokahta	ráđđehusadvokáhta
ráđđenduohtadeamiŧ	ráđđenduohtadeamit
ráđđenráddjemaŧ	ráđđenráddjemat
ráđđeáddi	ráđđeaddi
ráđđádallamaŧ	ráđđádallamat
ráđđádallaŧ	ráđđádallat
ráŋggaštit	ráŋggáštit
ráŋggaštus	ráŋggáštus
ráŋggaštusa	ráŋggáštusa
ráŋggaštusášši	ráŋggáštusášši
ráŋggaštusč.	ráŋggáštusč.
ráŋggaštusčiekčama	ráŋggáštusčiekčama
ráŋggaštusčiekčan	ráŋggáštusčiekčan
ráŋggaštusčievččastemiid	ráŋggáštusčievččastemiid
ráŋggaštuvvojit	ráŋggáštuvvojit
ráŋggaštuvvot	ráŋggáštuvvot
ráŋggaštč.	ráŋggáštč.
ráŋggáštusaŧ	ráŋggáštusat
ráŋggáštusčievččesteami	ráŋggáštusčievččasteami
ráŋggáštuvvi	ráŋggáštuvvo
ráŋggáštuščiekčamis	ráŋggáštusčiekčamis
ráŋkaštusčievččasteami	ráŋggáštusčievččasteami
ráŋŋá	ránnjá
rážan	ražan
sabehiiddes	sabehiiddis
saddat	šaddat
sadjai	sadjái
sadjasaš	sadjásaš
sadjánit	sadjanit
sadjásas	sadjásaš
sadsjásaš	sadjásaš
sahendimbaraŧ	sahendimbarat
sahka	sáhka
sahkkekeahtes	sahkketkeahtes
sahkkohallá	sáhkkohallá
sahtan	sáhttán
sahtašii	sáhtášii
sahtelihtain	satellihtain
sahten	šatain
sahtet	sáhttet
sahtii	sáhtii
sahtta	sáhttá
sahtá	sáhttá
sajaiduvven	sajáiduvven
sajáduvvon	sajáiduvvon
sallihit	sallidiid
salás	salas
samedikkeplánas	sámedikkeplánas
samedikkeáirras	sámediggeáirras
samegiela	sámegiela
samegielat	sámegielat
samegillii	sámegillii
sameland	Sameland
samemeasttirvuoittu	sámemeasttirvuoittu
samepolitihkkárat	sámepolitihkkárat
sami	sámi
samid	sámiid
samiide	sámiide
sampleid	sampliid
samvirkke	ovttasdoaimma
saniteahta	sanitehta
sapmelaš	sápmelaš
sarggaide	sárggáide
sartni	sártni
sasjái	sadjái
satjái	sadjái
satni	sátni
satnjida	sakŋida
satnjidit	sakŋidit
sattahallá	sattáhallá
sattai	šattai
savdnjan	savdnján
savkosit	savkosii
savvaba	sávvaba
savvat	sávvat
sddejuvvo	sáddejuvvo
sddet	sáddet
seaidne	seaidni
seammalagan	seammalágan
seammalagaš	seammalágaš
seammalágant	seammaláganat
seammasullásaččat	seammásullásaččat
seammasullásaš	seammásullásaš
seamms	seammás
seammáš	seammás
seanga	seaŋga
seanganissona	seaŋganissona
seanganissonii	seaŋganissonii
seanganissoniidda	seaŋganissoniidda
seanganissonis	seaŋganissonis
seanjásmuohttagiinna	seaŋášmuohttagiin
seanjážin	seaŋážin
searvai	searvái
searvalagaid	searválagaid
searvebinna	searvebinná
searvegotteráđii	searvegotteráđi
searveorganisašuvnnaŧ	searveorganisašuvnnat
searveriggodaŧ	searveriggodat
searválága	searválaga
seavdjat	seavdnjat
seađašii	seađášii
seksuala	seksuála
seksualaláhkarihkkulávdegotti	seksuálaláhkarihkkunlávdegotti
seksualaččat	seksuálalaččat
sekunddás	sekunddas
selggodit	šelggodit
semi-finalisttat	semifinalisttat
semifinalain	semi-finálain
semifinalas	semifinálas
seminara	seminára
seminaras	semináras
seminárai	seminárii
semma	seamma
senahta	senáhta
senahtoran	senáhtoran
sengii	seŋgii
serdodateallin	servodateallin
seremoniain	seremoniijain
servdodatfága	servodatfága
servegottis	searvegottis
servodatoeallima	servodateallima
servodatovdaneami	servodatovdáneami
servodatovdáneapmai	servodatovdáneapmái
servvet	servet
servviguin	servviiguin
servára	servera
sestii	sesttii
sevdnjadin	seavdnjadin
seven	serven
sevodatásahusat	servodatásahusat
shttet	sáhttet
si	sii
sida	siđa
sidai	siđai
sidduin	siidduin
siddus	siiddus
sidjide	sidjiide
sidjiidda	sidjiide
siearradoarjaga	sierradoarjaga
siehtadallančoahkkimiid	šiehtadallančoahkkimiid
siehtadus	šiehtadus
sieludet	silodet
sierrabibliiotehka	sierrabibliotehka
sierraduopmostuoluŧ	sierraduopmostuolut
sierralagaid	sierralágaid
sierralagan	sierralágan
sierranaš	sierranas
sierraoavilistis	sierraoaivilisttis
siesa	siesá
siessa	siessá
siffera	siffara
signalaid	signálaid
signalat	signálat
signáliseret	signaliseret
sihkarasttit	sihkkarastit
sihkarasttojuvvon	sihkkarastojuvvon
sihkarastá	sihkkarastá
sihkarastášedje	sihkkarasttášedje
sihkaris	sihkkaris
sihkarit	sihkkarit
sihkaruššat	sihkkaruššat
sihkaruššá	sihkkaruššá
sihkkarasta	sihkkarastá
sihkkarastašii	sihkkarasttášii
sihkkarastenbirrasa	sihkkarastinbirrasa
sihkkarasttan	sihkkarasttán
sihkkarasttašii	sihkkarasttášii
sihkkarastášii	sihkkarasttášii
sihkkár	sihkkar
sihkkárastit	sihkkarastit
sihkkárit	sihkkarit
sihkkárvuođamunni	sihkkarvuođamunni
sihkár	sihkar
sihttá	sihtá
sihttán	sihtan
siidjiide	sidjiide
siiggahagat	siiggádat
siiguin	singuin
siin	sin
siinguin	singuin
siivožit	siivvožit
siivut	siivvut
sikkarit	sihkkarit
silbajorbba	silbajorbbá
silbavirjjiid	silbaviljjiid
silluičuohci	silluičuohcci
sirddatgaska	sirddagaska
sirddolaččaŧ	sirddolaččat
sirdojuvve	sirdojuvvo
sirdášuvvan	sirdašuvvan
sirkkus	sirkus
sisaboaduid	sisaboađuid
sisabáhkemiid	sisabahkkemiid
sisagáikun	sisagaikun
sisbeassima	sisabeassama
sisbáhkemiid	sisabahkkemiid
sisbándygilvvuin	sisbandygilvvuin
sisbándyroadda	sisbandyroadda
sisdoalla	sisdoallá
sisialačča	sisilialačča
sisialaččain	sisilialaččain
sisilialáččat	sisilialaččat
sisilialáš	sisilialaš
siskabealde	siskkabealde
siskaldas	siskkáldas
siskildit	siskkildit
siskilusaid	siskilušaid
siskkalbealde	siskkabealde
siskkelii	siskelii
siskkelis	siskelis
siskobealde	siskkobealde
siskobeallái	siskkobeallái
siskáldas	siskkáldas
siskáldasat	siskkáldasat
sistisdoallá	sisttisdoallá
sistisdollet	sisttisdollet
sisttisdoalla	sisttisdoallá
sisábáhkkehemiin	sisabahkkehemiin
sisáfievrredan	sisafievrredan
sitahta	sitáhtta
sivahalla	sivahallá
sivahállá	sivahallá
sivakeahttá	sivatkeahttá
sivila	siviila
sivilašuvdna	sivilisašuvdna
sivilisšuvdna	sivilisašuvdna
sivvá	sivva
sivván	sivvan
sivá	siva
siváid	sivaid
siválaš	sivalaš
skabmamánu	skábmamánu
skallui	skállui
skapmamanus	skábmamánus
skeankka	skeaŋkka
skeaŋkain	skeaŋkkain
skeaŋkii	skeŋkii
skelbmoseapmi	skelbmošeapmi
skenkii	skeŋkii
skerttehii	skerttegii
skeŋkaaddin	skeaŋkaaddin
skieivvustisgoahtá	skiivvustišgoahtá
skievtteheapme	skievttaheapme
skihpar	skihpár
skihppáračča	skihpáračča
skihppáraččat	skihpáraččat
skihppáriid	skihpáriid
skihppáriidda	skihpáriidda
skihppáriiddis	skihpáriiddis
skihppáriiguin	skihpáriiguin
skihppáriin	skihpáriin
skiipagáhpálagaid	skiipagáhppálagaid
skiippii	skiipii
skirtteha	skirttega
skoaddi	skoađđi
skoalttáid	skoalttaid
skoalttát	skoalttat
skohpoša	skuhpoža
skohteriiin	skohteriin
skohtermáđiiját	skohtermáđijat
skoltálaš	skoltalaš
skoltásámi	skoltasámi
skopriuvdna	skorpiovdna
skullas	skuvllas
skulvllagurssiid	skuvllagurssiid
skunálaccat	skunálaččat
skuožirdit	skuožurdit
skuttervuodjit	skutervuoddjit
skuvlabiret	skuvlabiiret
skuvlainternahttii	skuvlainternáhttii
skuvlakatiinná	skuvlakantiinna
skuvlakatologaid	skuvlakatalogaid
skuvlaluohkaid	skuvlaluohkáid
skuvlašiljjus	skuvlašiljus
skuvllai	skuvlii
skuvllapensumma	skuvllapensuma
skuvllaskihppáriin	skuvlaskihpáriin
skuvllaseahkkain	skuvlaseahkain
skuvllaseahkkii	skuvlasehkkii
skuvllaváccin	skuvlavázzin
skuvllás	skuvllas
skábamanu	skábmamánu
skáhpput	skáhppot
skávzzáid	skávžžáid
skávža	skávžá
skávžžaid	skávžžáid
slakt	Slakt
sloahta	šloahta
sloahtta	šloahtta
smadahkes	smáđáhkes
smavisin	smávisin
smađahkes	smáđáhkes
smađáhkes	smáđáhkes
smađáhkkat	smáđáhkkásat
smegiela	sámegiela
smiehtttan	smiehttan
smiid	sámiid
smádáhkis	smáđáhkis
smáđahkes	smáđáhkes
snowboardda	snowboarda
snáhppat	snáhppát
soabadankommišuvnnaŧ	soabadankommišuvnnat
soabadiŧ	soabadit
soabhemiide	soabahemiide
soadnjuide	soagŋuide
soahkai	soahkái
soahpamušaigun	soahpamušaiguin
soahpana	soahpama
soahpmiidda	soahpamiidda
soahppat	soahpat
soahteveagaŧ	soahteveagat
soaitašii	soaittášii
soaite	soaitte
soaittahagaide	soaittáhagaide
soaittahagas	soaittáhagas
soaittahahkii	soaittáhahkii
soaittahat	soaittáhat
soaittahatprinsihpa	soaittáhatprinsihpa
soaittaše	soaittáše
soaittašii	soaittášii
soalddaha	soalddáha
soalddahiid	soalddáhiid
soalddahiidda	soalddáhiidda
soalddat	soalddát
soapmasa	soapmása
soapmasat	soapmásat
soapmasiidda	soapmásiidda
soapmasiin	soapmásiin
sofa	soffá
soffa	soffá
soffai	soffái
soffaid	soffáid
sohkabeal	sohkabealli
sohkabealebálanssa	sohkabealebalánssa
sohkariid	sohkkariid
sohkka	sohka
sohpojuvvo	sohppojuvvo
soisiála	sosiála
soitá	soaitá
sojáha	sojaha
sokcame	sokčame
som	son
soma	somá
somas	somás
somes	soames
sorjakeahtes	sorjjaskeahtes
sorjankehttá	sorjjakeahttá
sorjevaš	sorjavaš
sorjjavaš	sorjavaš
sorjuskeahttá	sorjjakeahttá
sosialalaš	sosiálalaš
sosialistalaš	sosialisttalaš
sosialála	sosiálalaš
sosiál	sosiála
sosiáladarvinisma	sosiáladarwinisma
sosiálaččat	sosiálalaččat
sosiálbávlaluslágá	sosiálabálvaluslága
sosiáldoaimmahat	sosiáladoaimmahat
sosiáldovddolaš	sosiáladovddolaš
sosiálfuolla	sosiálafuolla
sosiálfágain	sosiálafágain
sosiálstivrras	sosiálastivrras
sotnabeaivskuvla	sotnabeaiskuvla
sotnabeaivviid	sotnabeivviid
sotnábeaivvi	sotnabeaivvi
sovken	sovkken
sovkenis	sovkkenis
soáđáskan	soađáskan
spabbačiekčanjoavkku	spábbačiekčanjoavkku
speadjalastiidet	speadjalasttiidet
spelemann	spelleman
spelemannvuoiti	spellemanvuoiti
spesiáloahpahus	spesiálaoahpahus
spesialistaoahppuin	spesialistaoahpuin
spesialistdearvvašvuođabálvalusas	spesialistadearvvašvuođabálvalusas
spiehkastagaŧ	spiehkastagat
spiidneinfluensa	spiidneinflueansa
spitnjelávlumiin	spitnjalávlumiin
spábbačiekanjoavkku	spábbačiekčanjoavkku
spábbačikčanjoavkku	spábbačiekčanjoavkku
spábbačikčiekči	spábbačiekči
spábbá	spábba
spábbáčiekčanjoavkku	spábbačiekčanjoavkku
spádain	spáđain
spáppá	spáppa
srdni	sárdni
stahtagirku	stáhtagirku
stahtačálli	stáhtačálli
stallu	stállu
staluid	stáluid
status	stáhtus
statusa	stáhtusa
stađoheamit	stađuheamit
stađoheapmi	stađuheapme
steamppal	steampal
steapmila	steampila
stempelasttejuvvo	steampalastojuvvo
stipendiahta	stipendiáhta
stiverenvuohki	stivrenvuohki
stivrenjaovku	stivrenjoavku
stivrráláhtto	stivralahttu
stoagoslágan	stoaguslágan
stoaidá	stoaida
stoaluihit	stoaluhit
stohkkejaldnjái	stohkkejalgŋái
storyboard`as	storyboardas
stovo	stobu
stovu	stobu
stovus	stobus
strandebarmmaid	strandebarmmahiid
strategiijjaid	strategiijaid
strategijat	strategiijat
strategálaš	strategalaš
streassii	stressii
streaŋgát	streaŋggat
streikkas	streaikkas
studeantaid	studeanttaid
studeanttaidde	studeanttaide
studenanttat	studeanttat
stummiid	stuimmiid
stuodeanttat	studeanttat
stuoibmi	stuibmi
stuorabut	stuorábut
stuoradiggereŋkku	stuorradiggereŋkko
stuoramus	stuorámus
stuoramusat	stuorámusat
stuorasevodaga	stuoraservodaga
stuormus	stuorámus
stuorraid	stuorráid
stuorramus	stuorámus
stuorran	stuorisin
stuorrat	stuorrát
stuorriduvvo	stuoriduvvo
stuorrodat	sturrodat
stuorrodagat	sturrodagat
stáhtabaŋkkuin	stáhtabáŋkkuin
stuorrámus	stuorámus
stuorráŧ	stuorrát
stuorušii	sturošii
stuorá	stuora
sturamus	stuorámus
sturrut	sturrot
stádai	stádii
stáha	stáhta
stáhatid	stáhtaid
stáhtaborggáriida	stáhtaborgáriidda
stáhtadivatnjuolggadusaŧ	stáhtadivatnjuolggadusat
stáhtadoarjaha	stáhtadoarjaga
stáhtaministtara	stáhtaministara
stáhtaministtarii	stáhtaministarii
stáhtaministtariin	stáhtaministariin
stáhtá	stáhta
stáhtáeiseválddiid	stáhtaeiseválddiid
stáinnára	stáidnára
stálledoaimmahagaŧ	stálledoaimmahagat
stándardda	standárdda
stánžžii	stánžži
stárfu	stáffu
stárgasis	stargasis
stárggas	starggas
státha	stáhta
stáđuheapme	stađuheapme
stáđđasis	stáđđásis
substansiella	substansiealla
suddegáddai	suddegáddái
sudje	suddje
sudjejin	suddjejin
sudjen	suddjen
sudjet	suddjet
sudnje	sutnje
sudnuidda	sudnuide
suffaid	suffáid
sulai	sulaid
sulasaš	sullasaš
sullasažat	sullasaččat
sullastahttet	sulastahttet
sulli	sullii
sulliid	sullii
sulllii	sullii
sulloin	sulluin
suláid	sulaid
sulástáhtá	sulastahttá
summalin	summal
summalis	summal
summel	summal
summál	summal
summális	summal
sunnje	sutnje
sunno	sudno
sunnos	sudnos
suodjalusministtariin	suodjalusministariin
suodjegahppir	suodjegahpir
suoggardit	suokkardit
suohkanant	suohkanat
suohkalaš	suohkanlaš
suohkaiin	suohkaniin
suohkaniida	suohkaniidda
suohkanstivrrii	suohkanstivrii
suohkaná	suohkana
suohkastivrraáigodagas	suohkanstivraáigodagas
suohkkinjietna	šuohkkinjietna
suohkánii	suohkanii
suohpamuš	soahpamuš
suohpamušaid	soahpamušaid
suohtasat	suohttasat
suohttsii	suohttasii
suoidemánu	suoidnemánu
suoidnemnu	suoidnemánu
suolada	suoláda
suoladan	suoládan
suoladat	suoládat
suoladeamen	suoládeamen
suoladii	suoládii
suoladit	suoládit
suoladuvvon	suoláduvvon
suoldait	suoládit
suolle-maččat	suollemasat
suoma-ugrálaš	suoma-ugralaš
suorggehahtti	suorggahahtti
suorggiin	surggiin
suorgihahtti	suorggahahtti
suovastuhttejit	suovastuhttet
suroheapmi	suruheapme
surohemiid	suruhemiid
surulaš	surolaš
susttasii	susttašii
susttáša	susttaša
svaldagaid	sávaldagaid
svaldat	sávaldat
syhkkelasttimii	sihkkelastimii
syhkkelasttit	sihkkelastit
symboleaffeakta	symbolaeffeakta
symobola	symbola
systematalaččat	systemáhtalaččat
systemáhtalaccat	systemáhtalaččat
systemátiseret	systematiseret
sábehiid	sabehiid
sábehiiguin	sabehiiguin
sábetjoavku	sabetjoavku
sáddejuvui	sáddejuvvui
sáddejuvvoi	sáddejuvvui
sáddejuvvut	sáddejuvvot
sádjai	sadjái
sádji	sadji
sádjásaš	sadjásaš
sága-stallamiid	ságastallamiid
ságajođideaddjin	ságajođiheaddjin
ságakušan	ságaškušan
ságakuššat	ságaškuššat
ságakuššen	ságaškuššen
ságastallam	ságastallama
sáhkki	sáhkkii
sáhpan	sáhpán
sáhpanat	sáhpánat
sáhpandieva	sáhpándievá
sáhpaniid	sáhpániid
sáhpanlávlagiid	sáhpánlávlagiid
sáhpanmáilmmis	sáhpánmáilmmis
sáhpannieidda	sáhpánnieidda
sáhpannieiddaid	sáhpánnieiddaid
sáhpannieiddat	sáhpánnieiddat
sáhpanáiggi	sáhpánáiggi
sáhpančivgan	sáhpánčivgan
sáhpančivggaide	sáhpánčivggaide
sáhpančivggat	sáhpánčivggat
sáhpančivggažat	sáhpánčivggažat
sáhppángillár	sáhpángillár
sáhtan	sáhtán
sáhtat	sáhtát
sáhtet	sáhttet
sáhti	sáhtii
sáhtibehtet	sáhttibehtet
sáhtta	sáhttá
sáhttan	sáhttán
sáhttiiba	sáhttiba
sáhtttán	sáhttán
sáhtá	sáhttá
sáhtášivčče	sáhtášedje
sáivaguolasteami	sáivaguolásteami
sájes	sajes
sáji	saji
sájis	sajis
sájuštuvvo	sajuštuvvo
sálbmagirjiide	sálbmagirjjiide
sálloša	sállaša
sáltečuovčča	sáltečuovža
sámastit	sámástit
sámedigge	sámediggi
sámedikkeairras	sámediggeáirras
sámedikkiprográmma	sámediggeprográmma
sámegieala	sámegiela
sámegielaigun	sámegielaiguin
sámegielmahttu	sámegiellamáhttu
sámegieloahpa-headdjit	sámegieloahpaheaddjit
sámegilii	sámegillii
sámegilliii	sámegillii
sámekultuvrapolitihkkalaš	sámekulturpolitihkalaš
sámelágá	sámelága
sámemá-náid	sámemánáid
sámemánaid	sámemánáid
sámepolithkalaš	sámepolitihkalaš
sámepolitihkkalaš	sámepolitihkalaš
sámepolitihkálaš	sámepolitihkalaš
sámepoltihkalaš	sámepolitihkalaš
sámeservosiš	sámeservošis
sámeservvit	sámesearvvit
sámgiela	sámegiela
sámid	sámiid
sámidáidarat	sámedáiddárat
sámielbmotbeaivvi	sámeálbmotbeaivvi
sámii	sámi
sámpmelaččaid	sápmelaččaid
sámpmelaččaide	sápmelaččaide
sánggáriid	sáŋgáriid
sániguin	sániiguin
sániides	sániidis
sánalaččat	sánálaččat
sápemalaččaid	sápmelaččaid
sápmai	sápmái
sápmalaččaide	sápmelaččaide
sápmelaccaid	sápmelaččaid
sápmelaccaide	sápmelaččaide
sápmelaccat	sápmelaččat
sápmi-olmmoš	sápme-olmmoš
sápmálaččaid	sápmelaččaid
sárdideaddji	sárdnideaddji
sárdnestuolos	sárdnestuolus
sárdniidan	sárdnidan
sárdniidin	sárdnidin
sárdnijeaddjiid	sárdnideddjiid
sárdnunaiggi	sárdnunáiggi
sárggain	sárggáin
sárggosat	sárgosat
sárnestuollu	sárdnestuollu
sárnestuolu	sárdnestuolu
sártnisdis	sártnistis
sásttuhan	suosttuhan
sátkkuŧ	sátkkut
sátnai	sátnái
sátneartihkalis	sátneartihkkalis
sátnedaddamii	sátnádaddamii
sátnedaddamiidda	sátnádaddamiidda
sátnedaddan	sátnádaddan
sátnejođheaddji	sátnejođiheaddji
sátnejođiheaddjiávalus	sátnejođiheaddjiárválus
sátnesovken	sátnesovkken
sátnevuorka	sátnevuorká
sátnevátjasiid	sátnevádjasiid
sátnjejođiheaddji	sátnejođiheaddji
sáttovuova	sáttosuova
sávcaboanddaid	sávzaboanddaid
sávcca	sávzza
sávccaid	sávzzaid
sávccaide	sávzzaide
sávccamielki	sávzzamielki
sávccat	sávzzat
sávva	sávvá
sávvámis	sávvamis
sávzádoallu	sávzadoallu
sáváldaga	sávaldaga
sáváldagaid	sávaldagaid
sáváldat	sávaldat
sáván	sávan
sáŋggar	sáŋgár
sážu	sázu
tabeahta	tableahta
tabeahtaid	tableahtaid
tabeahtain	tableahtain
tabeahtat	tableahtat
tabealhat	tableahta
tabelahtat	tableahtat
tamperees	Tamperes
tariffašieahtadusain	tariffašiehtadusain
tarriffašiehtadusaid	tariffašiehtadusaid
tdajai	dajai
teaknihka	teknihka
teakstta	teavstta
tealtta	tealttá
tearmiidna	termiidna
tearmus	termos
teastamentta	testamenttá
teat	leat
teater	teáhter
teater-govahallamiid	teáhtergovahallamiid
tegnegat	tevnnegat
tegnegiid	tevnnegiid
tegnen	tevdnen
tehknihkalažžii	teknihkalažžii
tekhkkii	teknihkkii
teknalaccat	teknalaččat
teknihkkálaš	teknihkkalaš
teknihkálaš	teknihkalaš
teknikalaččat	teknihkalaččat
telemedisinain	telemedisiinnain
teledálkkasa	teledálkasa
telefun	telefovdna
temperatuvrraguin	temperatuvrraiguin
tempertuvra	temperatuvra
teologálaš	teologalaš
teorehtalalaččat	teorehtalaččat
teorehtálaš	teorehtalaš
teorhtalalaččat	teorehtalaččat
teorhtalaš	teorehtalaš
teorija	teoriija
terapautaide	terapevttaide
terapeuta	terapevta
terapeutii	terapevtii
termala	termála
terminologia	terminologiija
tevnnemis	tevdnemis
teátheris	teáhteris
tiima	tiimma
tiimas	tiimmas
tiinet	dinet
tjekkiija	Tsjekkia
tlt.	tlf.
toppscorár	toppscorer
toppscorárin	toppscorerin
tođđajagimánu	ođđajagemánu
trahpaide	tráhpaide
traktur	tráktor
trakturheaŋgáris	tráktorheaŋgáris
triumf	Triumf
tuberkolosedárkkistanduođaštus	tuberkolosadárkkistanduođaštus
tullját	tulját
tuollui	tullui
turastagihppagiin	turistagihppagiin
turistaid	turisttaid
turistaide	turisttaide
turneringsjoavku	turnerenjoavku
tursitta	turistta
tursittaid	turisttaid
tursittaide	turisttaide
turusttaid	turisttaid
tábuan	tabun
uhcca	uhca
uhccibuš	uhcibuš
uhcciduvvot	uhciduvvot
uhccimus	uhcimus
uhccimusat	uhcimusat
uhccit	uhcit
uhcimušge	uhcimusge
uhcuda	uhccuda
uhcudit	uhccudit
uhkadusa	uhkádusa
uhkkidit	uhkidit
uhkkiduvvon	uhkiduvvon
uvhrriid	uvhriid
ujes	ujos
uksaraigge	uksaráigge
ulbmilaččaŧ	ulbmillaččat
ulbmilid	ulbmiliid
ulbmiliida	ulbmiliidda
ulbmilmearrádusaŧ	ulbmilmearrádusat
ulbmilparagrafas	ulbmilparagráfas
ullodingga	ullodiŋgga
uniuvdna	uniovdna
uniuvdna-šiehtadus	uniovdnašiehtadus
uniuvdnaguovlu	uniovdnaguovlu
uniuvdnii	uniovdnii
uniuvnna	uniovnna
uniuvnnas	uniovnnas
universitehtta	universitehta
univeršitehtaid	universitehtaid
univeršitehtaide	universitehtaide
univeršitehtain	universitehtain
unnan	unnán
unnanaš	unnánaš
unnaraččaide	unnoraččaide
unnaraččat	unnoraččat
unnibiin	unnibuin
unnibuččai	unnibuččaid
unniduvo	unniduvvo
unniduvui	unniduvvui
unnišedje	unnošedje
unntloguálbmogiidda	unnitloguálbmogiidda
unnušdje	unnošedje
unnušedje	unnošedje
unná	unna
unohasta	unohastá
unohaš	unohas
unuhas	unohas
unuhassan	unohassan
usA	USA
ustit-vuođadánssuin	ustitvuođadánssuin
va	vai
vaccedettiin	váccedettiin
vaffelat	váffelat
vahagin	vahágin
vahkolaohpa	vahkuloahpa
vahkosaš	vahkkosaš
vahkui	vahkkui
vahá-gahttomiidda	vahágahttomiidda
vahágahttan	vahágahtton
vahágahttikeahttá	vahágahtikeahttá
vahágahttoŧ	vahágahttot
vahágain	vahágin
vaiban	váiban
vaibá	váibá
vaikkuha	váikkuha
vaikkuhangaskaoapmin	váikkuhangaskaoapmin
vaikkuhit	váikkuhit
vaikkuhusat	váikkuhusat
vaikkuhusčielggadeami	váikkuhusčielggadeami
vaiko	vaikko
vaillevaš	váilevaš
vailu	váilu
vaimmolas	váimmolaš
vaimmolaš	váimmolaš
vaivvit	váivvit
vajalduhte	vajálduhte
vajalduhtteba	vajálduhttiba
vajalduhttet	vajálduhttit
vajalduhttit	vajálduhttit
vajalduhttán	vajálduhttán
vajalduvvon	vajálduvvan
vajádahttit	vajáldahttit
vajáldahtan	vajáldahttán
vajálduvvo	vajálduvvá
vajálduvvojedje	vajálduvve
vajálduvvojit	vajálduvvet
valaštallamii	valáštallamii
valaštallan	valáštallan
valaštallandoaluide	valáštallandoaluide
valdet	váldet
valdit	váldit
valdá	váldá
valgaguovlu	válgaguovlu
valljema	válljema
valljet	válljet
valljiide	válljiide
valljit	valjit
valmmasin	válmmasin
valátalliid	valáštalliid
valáštallandoaimmmaide	valáštallandoaimmaide
valáštallanhallas	valáštallanhállas
valáštallanhallá	valáštallanhálla
vankurskkisin	vanhurskkisin
vari	vári
variášuvdna	variašuvdna
varri	várri
varrogasat	várrogasat
varuhit	váruhit
varás	várás
vasahusat	vásáhusat
vastida	vástida
vastidii	vástidii
vastidin	vástidin
vattis	váttis
vattisvuodat	váttisvuođat
vattisvuođa	váttisvuođa
vattisvuođat	váttisvuođat
vazzit	vázzit
vašalaččat	vašálaččat
vašalaš	vašálaš
vašalažžii	vašálažžii
vašanat	vašánat
veaddjemeahtton	veadjemeahttun
veaddjemeahttun	veadjemeahttun
veadiduvvot	veardiduvvot
veadja	veadjá
veadjan	veadján
veagalváldan	veagalváldán
veaha	veahá
veahaš	veaháš
veahkatallat	veahkehallat
veahketasttat	veahkehasttát
veahkešivččet	veahkehivččet
veahkkedivššos	veahkkedivššus
veahkkehan	veahkehan
veahkkehit	veahkehit
veahkkfoanda	veahkkefoanda
veahkklagaid	veahkkálagaid
veaige	veaige-
veaikeminerálaŧ	veaikeminerálat
veajat	veaját
veajašii	veajášii
vealggisihkkun	vealggesihkkun
vealggáidahttá	vealggáiduhttá
vealladansadjái	vealládansadjái
vealladii	vealládii
vealladii3	vealládii
veallai	veallái
vealtakeahtes	vealttakeahtes
vealtakeahttá	vealttakeahttá
vealttameahttun	vealtameahttun
vear	veara
veardadallojuvvojit	veardádallojuvvojit
veardidt	veardidit
veardiduvui	veardiduvvui
vearrai	vearrái
vearrofriddjavuoda	vearrofriddjavuođa
vearrogáibideaddjiŧ	vearrogáibideaddjit
vearroráhtoásahuš	vearroráhtoásahus
vearrot	vearrut
vearrováldiŧ	vearroválddit
vearruluoittu	vearroluoittu
vearránu	vearrána
vearudet	verodet
veará	veara
veha	vehá
vehaš	veháš
vehiide	vehkiide
vehás	veháš
vejola	vejolaš
vejolas	vejolaš
vejolavuohta	vejolašvuohta
vejolasvuođat	vejolašvuođat
vejolaš-vuohta	vejolašvuohta
vejolaš-vuođa	vejolašvuođa
vejolašvuoda	vejolašvuođa
vejolašvuodat	vejolašvuođat
vejolašvuođ	vejolašvuođa
vejolašvuđaid	vejolašvuođaid
vela	velá
verd-devuođas	verddevuođas
verrogielaid	vearrogielaid
vibra-šuvnnaid	vibrašuvnnaid
video:ain	videoin
vidjat	bidjat
vidáseappot	viidáseappot
vidát	viđat
viegaidviegaid	viegaid-viegaid
viehkkalii	viehkalii
vieljja	vielja
vieljjas	vieljas
vielljaiguin	vieljaiguin
vielljain	vieljain
vielljainam	vieljainan
vielljastam	vieljastan
vielljaš	vieljaš
vielljaža	vieljaža
vierro	vierru
vieruduvvamii	vieruiduvvamii
viervvágiid	viervváid
viesot	visot
viesso	viessu
viessohuksejeaddjiŧ	viessohuksejeaddjit
viessosáji	viessosaji
vieurid	vieruid
viežža	viežžá
viežžakeahttá	vieččakeahttá
vihatbeaivvi	vihabeaivvi
vihatlohkosiid	vihalohkosiid
vihkedalla	vihkkedallá
vihkedallá	vihkkedallá
vihkesteamen	vihkkesteamen
vihta	vihtta
vihtannuššančilgehusain	vihtanuššančilgehusain
vihttaloht	vihttalot
vihttalotduhát	vihttalogiduhát
vihttanuplot	vihttanuppelot
vihtána	vihtana
vihtánat	vihtanat
viháhuvvot	vihahuvvot
viidabut	viidábut
viidasat	viidásat
viidaseabbot	viidáseappot
viidaseappot	viidáseappot
viidaset	viidáset
viidasit	viidásit
viidat	viidát
viiddaseappot	viidáseappot
viiddedeami	viiddideami
viiddiduvvont	viiddiduvvon
viiddiida	viiddida
viiddiidit	viiddidit
viiddiiduvvo	viiddiduvvo
viiddát	viidát
viidideami	viiddideami
viididit	viiddidit
viidnaboahttala	viidnaboahtala
viidnebohtala	viidnebohttala
viidá-seappot	viidáseappot
viidábot	viidábut
viidábuot	viidábut
viidáseabbut	viidáseappot
viimmaskit	viimmáskit
viissuid	viessuid
viitamidnadálkkasat	vitamiidnadálkasat
vikkái	vikkai
vilgessáhpan	vilgessáhpán
vilgessáhpana	vilgessáhpána
vilgessáhpanat	vilgessáhpánat
vilgessáhpanbárdnái	vilgessáhpánbárdnái
vilgessáhpanbártniin	vilgessáhpánbártniin
vilgessáhpaniid	vilgessáhpániid
vilgessáhpaniiguin	vilgessáhpániiguin
vilgessáhpaniin	vilgessáhpániin
vilgesáhpanbártni	vilgessáhpánbártni
villeheagga	villaheagga
villeheakkain	villaheakkain
villeheakkat	villaheakkat
vilt	Vilt
vimmat	viimmat
virgefridjavuođas	virgefriddjavuođas
virggalaš	virggálaš
virggii	virggiid
virggisttis	virggistis
virgilobi	virgelobi
virjeskihlanassan	viljeskilanassan
virkut	virkot
vissalis	viššalis
vissasii	vissásii
vissasit	vissásit
visualalaš	visuálalaš
visut	visot
visža	visoža
vizárdii	vizardii
viđadin	viđádin
viđačiegaiin	viđačiegagiin
viđáin	viđain
višša	viššá
viššallit	viššalit
viššál	viššal
vldit	váldit
vmearriduvvon	mearriduvvon
vokala	vokála
vokalrievdamiiguin	vokálarievdamiiguin
vokalteknihkka	vokálateknihkka
vokálista	vokalista
vostá	vuostá
vouvdečuollamiin	vuovdečuollamiin
vovdnástallat	vuovnnastallat
vrigái	virgái
vsihit	vásihit
vttis	váttis
vuddosa	vuđđosa
vudolaccat	vuđolaččat
vugiinnis	vugiinis
vuhti	vuhtii
vuhtiváldá	vuhtiiváldá
vuhttii	vuhtii
vuhtui	vuhtii
vuibmii	vuoibmái
vuigatvuohta	vuoigatvuohta
vuimmiinnis	vuimmiinis
vuitii	vuittii
vuitit	vuoitit
vuitti	vuittii
vuittu	vuoittu
vulgii	vulggii
vulgiiga	vulggiiga
vulgiidet	vulggiidet
vulgiimet	vulggiimet
vuoddjinkoarta	vuodjinkoarta
vuoddoealáhusat	vuođđoealáhusat
vuoddoealáhusdoalliid	vuođđoealáhusdolliid
vuoddoealáhusdoalliide	vuođđoealáhusdolliide
vuoddu	vuođđu
vuoddudit	vuođđudit
vuodduduvvon	vuođđuduvvon
vuoddun	vuođđun
vuodima	vuovdima
vuodjemin	vuodjimin
vuodjet	vudjet
vuodji	vuoddji
vuodu	vuođu
vuodul	vuođul
vuogadagas	vuogádagas
vuogatvuođat	vuoigatvuođat
vuogádatlaččaŧ	vuogádatlaččat
vuohgki	vuohki
vuohkaseamos	vuohkkaseamos
vuohkki	vuohki
vuohkáhalai	vuohkadalai
vuohkáhallan	vuohkadallan
vuohtto	vuohttu
vuohččen	vuohččan
vuoi-gatvuođat	vuoigatvuođat
vuoibm	vuoibmi
vuoiden	vuiden
vuoidnjamiid	vuoigŋamiid
vuoidnjan	vuoigŋan
vuoidnjatge	vuoigŋatge
vuoigat-vuođat	vuoigatvuođat
vuoigatuohta	vuoigatvuohta
vuoigatvuoda	vuoigatvuođa
vuoigatvuodacielggadeapmi	vuoigatvuođačielggadeapmi
vuoigatvuodagáibádus	vuoigatvuođagáibádus
vuoigatvuodahámát	vuoigatvuođahámát
vuoigatvuodaid	vuoigatvuođaid
vuoigatvuodaide	vuoigatvuođaide
vuoigatvuodaideaset	vuoigatvuođaideaset
vuoigatvuodaiguin	vuoigatvuođaiguin
vuoigatvuodain	vuoigatvuođain
vuoigatvuodalaccat	vuoigatvuođalaččat
vuoigatvuodalaš	vuoigatvuođalaš
vuoigatvuodalažžii	vuoigatvuođalažžii
vuoigatvuodalávdegoddi	vuoigatvuođalávdegoddi
vuoigatvuodalávdegoddái	vuoigatvuođalávdegoddái
vuoigatvuodalávdegotti	vuoigatvuođalávdegotti
vuoigatvuodalávdegottis	vuoigatvuođalávdegottis
vuoigatvuodamiellahtu	vuoigatvuođamiellahtu
vuoigatvuodamálle	vuoigatvuođamálle
vuoigatvuodatge	vuoigatvuođatge
vuoigatvuodavuoddu	vuoigatvuođavuođđu
vuoigatvuohtá	vuoigatvuohta
vuoigatvuoiđaid	vuoigatvuođaid
vuoigatvuođ	vuoigatvuođa
vuoigatvuođagažalddagaid	vuoigatvuođagažaldagaid
vuoigatvuođahámáŧ	vuoigatvuođahámat
vuoigatvuođalaccat	vuoigatvuođalaččat
vuoigatvuođay	vuoigatvuođat
vuoigatvuođaŧ	vuoigatvuođat
vuoigatvuođe	vuoigatvuođa
vuoigavuohta	vuoigatvuohta
vuoigavuođadiehtagiid	vuoigatvuođadiehtagiid
vuoigavuođaid	vuoigatvuođaid
vuoim-mis	vuoimmis
vuoim-málaččat	vuoimmálaččat
vuoimmaide	vuimmiide
vuoinnastit	vuoiŋŋastit
vuoinnjasta	vuoiŋŋasta
vuoinnjastahtidit	vuoiŋŋastahttit
vuoinnjastahttima	vuoiŋŋastahttima
vuoinnjastahttit	vuoiŋŋastahttit
vuoinnjastan	vuoiŋŋastan
vuoinnjastandilli	vuoiŋŋastandilli
vuoinnjastit	vuoiŋŋastit
vuoite	vuoitte
vuoittohallan	vuoittáhallan
vuoittohallat	vuoittáhallat
vuoittohalle	vuoittáhalle
vuoitut	vuoittut
vuojadanbasseanga	vuojadanbasseaŋŋa
vuojadansálle	vuojadansále
vuojadanálddi	vuojadanálddis
vuojedettiin	vuojádettiin
vuojidettin	vuojidettiin
vuoktačuohppahagas	vuoktačuohpahagas
vuoktačuohppahat	vuoktačuohpahat
vuolabealde	vuolábealde
vuoldde	vuolde
vuolen	vuolis
vuolga	vuolgá
vuolgadis	vuolgagis
vuolge	vuolgge
vuolggahansádji	vuolggasadji
vuolggašii	vuolggášii
vuollaibáza	vuolláibáza
vuolláibáhcahagain	vuolláibáhcagiin
vuolláibázahaga	vuolláibáhcaga
vuolláibázahusas	vuolláibáhcagis
vuollaičálli	vuolláičálli
vuollaičállon	vuolláičállon
vuolleleabbui	vuollelebbui
vuolláičállan	vuolláičállán
vuoodieuid	vuođđodieđuid
vuoofágas	vuođđofágas
vuooáššit	vuođđoáššit
vuorbadeamis	vuorbádeamis
vuorbadit	vuorbádit
vuordamušat	vuordámušat
vuorddetkeahtes	vuorddekeahtes
vuoridt	vuordit
vuorkagovva	vuorkágovva
vuorkkagovat	vuorkkágovat
vuorkkain	vuorkkáin
vuorohuvvojit	vuoruhuvvojit
vuortnoheigga	vuortnuheigga
vuoru-hemiid	vuoruhemiid
vuoruhanbijjuid	vuoruhanbijuid
vuosargga	vuossárgga
vuose-husa	vuosehusa
vuose-husaid	vuosehusaid
vuose-husbihtá	vuosehusbihtá
vuosi-huvvojit	vuosihuvvojit
vuosta	vuostá
vuostabealde	vuosttabealde
vuostaiválddiidet	vuostáiválddiidet
vuostaiváldit	vuostáiváldit
vuostalastima	vuostálastima
vuostalasvuhtii	vuostálasvuhtii
vuostalasvuohta	vuostálasvuohta
vuostalasvuođaide	vuostálasvuođaide
vuostalda	vuosttalda
vuostaldit	vuosttaldit
vuostamužžan	vuosttamužžan
vuostas	vuosttas
vuostaš	vuosttaš
vuostažettiin	vuosttažettiin
vuostažettin	vuosttažettiin
vuostehagu	vuostehágu
vuostehahku	vuosteháhku
vuostelas	vuostálas
vuosteággavuogádaŧ	vuosteággavuogádat
vuostilda	vuosttilda
vuostildit	vuosttildit
vuostta-žettiin	vuosttažettiin
vuosttalastti	vuostálasti
vuosttalasttit	vuostálastit
vuosttasjienasteaddjiŧ	vuosttasjienasteaddjit
vuosttasvuoigatvuoda	vuosttašvuoigatvuođa
vuosttasvuoigatvuodain	vuosttašvuoigatvuođain
vuosttaá	vuosttaš
vuosttašiin	vuosttažin
vuosttašin	vuosttažin
vuosttažettin	vuosttažettiin
vuosttálaga	vuostálaga
vuosttálasttii	vuostálasttii
vuosttážettiin	vuosttažettiin
vuostálast	vuostálaste
vuostálastaše	vuostálasttáše
vuostálastejit	vuostálastet
vuostálastemen	vuostálastimen
vuostálastemiidde	vuostálastimiidda
vuostálasttá	vuostálastá
vuostálašvuohta	vuosttálašvuohta
vuostálašvuođa	vuosttálašvuođa
vuostánoadi	vuostánoađi
vuosárgga	vuossárgga
vuosátiváldimiidda	vuostáiváldimiidda
vuovdekeahttá	vuovddekeahttá
vuovdeossodaŧ	vuovdeossodat
vuovdinfállovuogiŧ	vuovdinfállovuogit
vuovdnájat	vuovdnát
vuovdájat	vuovdát
vuođolaččat	vuđolaččat
vuođolaš	vuđolaš
vuođoštit	vuođuštit
vuođos	vuođus
vuođđalága	vuođđolága
vuođđaoskuvladási	vuođđoskuvladási
vuođđobákteguovlluŧ	vuođđobákteguovllut
vuođđoduvvon	vuođđuduvvon
vuođđoduvvui	vuođđuduvvui
vuođđoelementtaid	vuođđoelemeanttaid
vuođđogeainnuŧ	vuođđogeainnut
vuođđonoađiŧ	vuođđonoađit
vuođđoskuvlain	vuođđoskuvllain
vuođđu-duvvojit	vuođđuduvvojit
vuođđuduvui	vuođđuduvvui
vuođđuduvvoi	vuođđuduvvui
vuođđuealáhussan	vuođđoealáhussan
vuođđukurssa	vuođđokurssa
vuođđuskuvla	vuođđoskuvla
vuođđuskuvlla	vuođđoskuvlla
vuođđuskuvllain	vuođđoskuvllain
vuođđuskuvllas	vuođđoskuvllas
vuošttaš	vuosttaš
vuoššestit	vuoššastit
vurrolagai	vurrolagaid
vuđoleabbut	vuđoleappot
vuđđolaččat	vuđolaččat
vvváikkuhusat	váikkuhusat
váccedettin	váccedettiin
váccet	vázzet
váddobastiid	váddobasttiid
vádjehis	vádjegis
váhkkodiimmut	vahkkodiimmut
váhkku	vahkku
váhko	vahku
váhkos	vahkus
váhkosaš	vahkkosaš
váhnemiiddeset	váhnemiiddiset
váhnemiide	váhnemiidda
váhnemiideaset	váhnemiiddiset
váhnemiideasetguin	váhnemiiddisetguin
váhnemiinnes	váhnemiinnis
váhnenkeahttás	váhnenkeahtes
váhnenmidda	váhnemiidda
váhneráđđi	váhnenráđđi
váhágiid	vahágiid
váhágin	vahágin
váhát	vahát
váibbihan	váibbahan
váibbihii	váibbahii
váibbihit	váibbahit
váibbitan	váibbahan
váibmolađisvuohta	váibmoláđisvuohta
váidalanásahuš	váiddaásahus
váidan	váidán
váiddagiidda	váidagiidda
váidinvuoigatvuoda	váidinvuoigatvuođa
váidinvuoigatvuodas	váidinvuoigatvuođas
váigadas	váigadis
váihkkuhusat	váikkuhusat
váikkkuhangaskaoamit	váikkuhangaskaoamit
váikkkuhusat	váikkuhusat
váikkoha	váikkuha
váikkohan	váikkuhan
váikkohangaskaomiid	váikkuhangaskaomiid
váikkoheamin	váikkuheapmin
váikkohit	váikkuhit
váikkohus	váikkuhus
váikkohusaid	váikkuhusaid
váikku	vaikko
váikku-han	váikkuhan
váikku-hanvejolašvuođat	váikkuhanvejolašvuođat
váikkuheaddjjiiguin	váikkuheddjiiguin
váikkutit	váikkuhit
váikuha	váikkuha
váikuhit	váikkuhit
váilevašvuoda	váilevašvuođa
váillatan	váillahan
váillevaš	váilevaš
váilojit	váilot
váilomin	váilumin
váishit	vásihit
váivášuvvat	váivašuvvat
vájolašvuođa	vejolašvuođa
vákšudemiide	vákšodemiide
vákšujeaddji	vákšojeaddji
válaštallan	valáštallan
válaštallanskuvllas	valáštallanskuvllas
válaštallanfeastta	valáštallanfeastta
válda	váldá
váldan	váldán
válddahalla	válddahallá
válddahallamistis	válddahallamisttis
válddan	válddán
válddašii	válddášii
válddiidettiin	válddidettiin
válddimiidda	váldimiidda
válddá	váldá
váldii	válddii
váldiŧ	váldit
váldodokomeanta	váldodokumeanta
váldogirdifierbmádaŧ	váldogirdifierpmádat
váldogirdiruvttuŧ	váldogirdiruvttut
váldogáaldat	váldogažaldat
váldogážaldat	váldogažaldat
váldojuvvoi	váldojuvvui
váldojuvvonn	váldojuvvon
váldokapitala	váldokapitála
váldoluohttamušaide	váldoluohttámušaide
váldonjuolggádusain	váldonjuolggadusain
váldoorgasnisašuvnnaide	váldoorganisašuvnnaide
váldoovttasbargoguoim-mit	váldoovttasbargoguoimmit
váldopoastain	váldopoasttain
váldoáššálaccat	váldoáššálaččat
váldó	váldo
válgadigge	válgadiggi
válgadohkálaš-vuohta	válgadohkálašvuohta
válgagiccu	válgagičču
válgagivvus	válgagilvvus
válgalohpparehkenastin	válgaloahpparehkenastin
válgobargu	váldobargu
válhastivrra	válgastivrra
váljejuvvo	válljejuvvo
váljejuvvon	válljejuvvon
váljemiidda	válljemiidda
váljen	válljen
váljet	válljet
váljii	válljii
váljis	valjis
váljje	vállje
váljjejit	válljejit
váljjejuvvon	válljejuvvon
váljjejuvvui	válljejuvvui
váljjejuvvun	válljejuvvon
váljjemii	válljemii
váljjemiidda	válljemiidda
váljjen	válljen
váljjet	válljet
váljjii	válljii
váljjis	valljis
vállejit	válljejit
vállejuvvot	válljejuvvot
válljejuvui	válljejuvvui
válljejuvvba	válljejuvvoba
válljejuvvoi	válljejuvvui
válljemistis	válljemisttis
válljeuvvot	válljejuvvot
válljis	valljis
válljji	válljii
válmmahuššadettiinis	válmmahušadettiinis
válvgaguovllu	válgaguovllu
váláštallafágain	valáštallanfágain
váláštallamiid	valáštallamiid
váláštallan	valáštallan
váláštallanfágaid	valáštallanfágaid
vánes	vánis
váraieđuheames	váraheames
váriabeliin	variábeliin
várohus	váruhus
várohusaide	váruhusaide
várohussii	váruhussii
várrejuvvojjit	várrejuvvojit
várrelahtui	várrelahttui
várrogagasvuođaide	várrogasvuođaide
várrá	várra
vártnohis	vártnuhis
várttisvuohta	váttisvuohta
vási-hus	vásihus
vási-husaid	vásihusaid
vási-husain	vásihusain
vássan	vássán
vássanáiggi	vássánáiggi
vástadus	vástádus
vástadusa	vástádusa
vástadusskovit	vástádusskovit
vástidiii	vástidii
vástiideigga	vástideigga
vástiidit	vástidit
vásttošta	vásttosta
vásttoštit	vásttostit
váttivuođat	váttisvuođat
vávvateahter	vávváteáhter
vázzan	vázzán
váøga	válga
váčči	vácci
váčče	vácce
vášis	vašis
vážžit	vázzit
ytringsfrihetskommisjona	Ytringsfrihetskommisjona
Áfrihkas	Afrihkás
Áfrihkkás	Afrihkás
Áfriika	Afrihkká
Áfriikii	Afrihkkái
Áfriikka	Afrihká
Áfriikkas	Afrihkás
ÁhKKU	áhkku
Áhkanas	Áhkkanas
Áhki	Ahki
Áhčežen	Áhčážan
Áiddo	Aiddo
Áidejávvris	Áidejávrris
Áigai	Áigái
Áiggid	Áiggiid
Áiggon	Áiggun
Áiggumuš	Áigumuš
Áigumus	Áigumuš
Áilluhažžain	Áillohaččain
Áisároaivvis	Áisaroaivvis
Áitesávu	Áitesavu
Ákkastepmi	Ákkasteapmi
Álbmotmusas	Álbmotmuseas
Álgofápmo	Álgofápmu
Áltagas	Álttagas
Áltta	Álttá
Áltta-áššis	Áltá-áššis
Álttas	Álttás
Álttavuona	Álttávuona
Ámeriika	Amerihkká
Ámeriikalaččat	Amerihkálaččat
Ámeriikii	Amerihkkái
Ámeriikka	Amerihká
Ámeriikkas	Amerihkás
Ánárjoga	Anárjoga
Árbevirolaccat	Árbevirolaččat
Áreálaplána	Areálaplána
Árvidsjávrri	Árvvesjávrri
Árvidsjávrái	Árvvesjávrái
Átlantta	Atlanta
Áviisasáhpan	Áviisasáhpán
Áššejodiheaddjiid	Áššejođiheddjiid
Áššenr	Áššenr.
Äärela	Äärelä
Åbo:as	Åbos
Åerjelhsaemien	Åarjelsaemien
Ålandda	Ålándda
Æsj	Eašš
Ætnamsearvi	Ætnansærvi
Ætnamsearvvi	Ætnansærvvi
Øyind	Øyvind
áaivve	aivve
ábaide	ábiide
ábbonat	ábbunat
ábortta	abortta
áddejuvvoŧ	áddejuvvot
áddestalla	áddestallá
áddi	addi
áddjat	ádját
áddjáža	ádjáža
áddo	addo
áddojuvvo	addojuvvo
áddái	addái
ádja	ádjá
ádjaid	ádjáid
ádjain	ádjáin
ádjas	áddjás
ádjága	ádjaga
áevvoštallat	árvvoštallat
ágibeaivvi	agibeaivvi
ágii	ággii
áhki	ahki
áhkidis	ahkidis
áhkkobat	áhkkubat
áhkos	áhkoš
áhperávnnjiŧ	áhperávnnjit
áhčeseani	áhčešeani
áhččam	áhččán
ái-gái	áigái
áibbás	áibbas
áica	áicca
áicalmas	áiccalmas
áicalmasaide	áiccalmasaide
áicalmassi	áiccalmassii
áiccamat	áicamat
áidan	áidna
áiddobeliid	aiddobeliid
áidná	áidna
áidojuvvvon	áidojuvvon
áig-ge	áigge
áiga	áigá
áigai	áigái
áige	áigge
áige-guovdilis	áigeguovdilis
áigeguov-dilis	áigeguovdilis
áigeguovdálaš	áigeguovdilis
áigehuvvamiidda	áiggehuvvamiidda
áigekompenašuvdna	áigekompensašuvdna
áigeráddjejuvvoŧ	áigeráddjejuvvot
áigges	áiggis
áiggii	áiggiid
áiggušeimmet	áiggošeimmet
áiggušii	áiggošii
áigiid	áiggiid
áigiodagas	áigodagas
áigiá	áigái
áigáš	áiggáš
áirasiiidda	áirasiidda
áirsasa	áirasa
áirrasa	áirasa
áirrasat	áirasat
áirrasiid	áirasiid
áirrasiin	áirasiin
áita	áitá
áittardeaddjiŧ	áittardeaddjit
áitto	aitto
áivve	aivve
ájehaddat	ájahaddat
ájehadden	ájahadden
ájehattan	ájahattan
áktiiva	aktiiva
álb-moga	álbmoga
álb-motšuoŋaid	álbmotšuoŋaid
álbma	albma
álbmaládje	albmaládje
álbmefuoddariin	álbmefuođđariin
álbmogs	álbmogis
álbmosii	albmosii
álbmotallaskovlla	álbmotallaskuvlla
álbmotmeahciš	álbmotmeahcis
álbmotregistárii	álbmotregistarii
álbmotrivttiiin	álbmotrivttiin
álddui	áldduid
álde	alde
álfarot	álfárot
álga	álgá
álgahan	álggahan
álgahuvvon	álggahuvvon
álgan	álgán
álggahuvvoi	álggahuvvui
álggahán	álggahan
álggaše	álggáše
álggi	álggii
álggugeahčen	álgogeahčen
álggáhit	álggahit
álginsátnistis	álginsánistis
álgodahkii	áigodahkii
álgogáldduid	álgogálduid
álgovuolggalaccat	álgovuolggalaččat
álgoálbmo-giid	álgoálbmogiid
álgoálbmoat	álgoálbmogat
álgumuš	áigumuš
álkiibun	álkibun
álkkes	álkes
álkkibun	álkibun
álkkibuin	álkibuin
álkkidivččii	álkidivččii
álkkimus	álkimus
álkkit	álkit
állergiija	allergiija
álmmohit	álmmuhit
álmmohuvvon	almmuhuvvon
álmmolaččat	almmolaččat
álmmolaš	almmolaš
álmmolašvuhtii	almmolašvuhtii
álmmolašvuohta	almmolašvuohta
álmmá	almmá
áltagas	álttagas
álttás	Álttás
ámadáju	ámadaju
ámadájut	ámadajut
ámerihkalaš	amerihkálaš
ámeriikalaččat	amerihkálaččat
ámmástis	ámmáhisttis
ándagassi	ándagassii
ángir	áŋgir
ánssaša	ánssáša
ánssašan	ánssášan
ánssašin	ánssášin
ánssašit	ánssášit
ánssašivčče	ánssášivčče
ánssásivčče	ánssášivčče
ánššášit	ánssášit
áobbas	áibbas
ápotehka	apotehka
árbbolaččaŧ	árbbolaččat
árbevierolaš	árbevirolaš
árbevir-olaš	árbevirolaš
árbevirlolaš	árbevirolaš
árbevirolaccat	árbevirolaččat
árbeviruid	árbevieruid
árbmut	árpmut
árenas	arenas
árjjaklaš	árjjalaš
árjjalaccat	árjjalaččat
árktisa	Árktisa
árpmikeahttá	árpmitkeahttá
ártihkkalis	artihkkalis
ártisttaide	artisttaide
ártisttaiguin	artisttaiguin
ártisttat	artisttat
árvalasttá	árvalastá
árvesáni	árvosáni
árvesátni	árvosátni
árvevieru	árbevieru
árvevierut	árbevierut
árvideeamis	árvideamis
árvlan	árvalan
árvlasttá	árvalastá
árvobábirmárkánat	árvobábirmárkanat
árvoštalla	árvvoštallá
árvoštallan	árvvoštallan
árvoštallat	árvvoštallat
árvvostallat	árvvoštallat
árvvoštalallaba	árvvoštallaba
árvvoštalašivččii	árvvoštalašii
árvvoštalla	árvvoštallá
árvvoštallajuvvo	árvvoštallojuvvo
árvvoštallamiida	árvvoštallamiidda
árvvoštallid	árvvoštalliid
árvvoštallojuvvoi	árvvoštallojuvvui
árvvošteamiin	árvvoštemiin
árvuvuođu	árvovuođu
ása-huvvomin	ásahuvvomin
ásadeamiin	ásademiin
ásahuat	ásahusat
ásahuvui	ásahuvvui
ássaŧ	ássat
ásside	ássiide
ássiŧ	ássit
ássándoarjaga	ássandoarjaga
átestit	áŧestit
átmosfearai	átmosferii
áttáše	attáše
ávcca	ávccá
ávdinin	ávdimin
ávesuvnnas	akšuvnnas
áviisaid	áviissaid
áviisain	áviissain
ávisii	áviisii
ávkkalaš	ávkkálaš
ávkkálaccat	ávkkálaččat
ávkkálaččaŧ	ávkkálaččat
ávkkástalln	ávkkástallan
ávnnalaš	ávnnaslaš
ávnnasliiggiŧ	ávnnasliiggit
ávtán	ávttán
ávuoigatvuođaiguin	vuoigatvuođaiguin
ávvirriidda	ávviriidda
ávvu-deami	ávvudeami
ávzzuhit	ávžžuhit
ávččuha	ávžžuha
ávžžuhuvvjot	ávžžuhuvvojit
áđđama	ađđama
áŋgirdeaddji	áŋggirdeaddji
áŋgirušša	áŋgiruššá
áŋguruššansuorggi	áŋgiruššansuorggi
áŋkke	aŋkke
áŋkkur	áŋkor
ášsi	ášši
áššai	áššái
áššaskuhtton	áššáskuhtton
áššebáhpirid	áššebáhpiriid
áššehaččaide	áššehasaide
áššehažžii	áššehassii
áššetemet	áššetemát
áššečuoččaldahttiŧ	áššečuoččáldahttit
áššečuoččileddjiid	áššečuožžileddjiid
áššid	áššiid
áššiguin	áššiiguin
áššiš	áššis
áššá-skuhttimiidda	áššáskuhttimiidda
áššái-duhttomiidda	áššáiduhttomiidda
áššáiguoskevaccat	áššáiguoskevaččat
áššáskuhttema	áššáskuhttima
áššáškuhttojuvvo	áššáskuhttojuvvo
åarjelsámegiela	oarjelsámegiela
åarjelsámegillii	oarjelsámegillii
økologalaš	ekologalaš
Čahcesullos	Čáhcesullos
Čalbmetbealskaidi	Čalbmebealskáidi
Čarajávrris	Čárajávrris
Čerus	Čeroš
Čiavrrasmielli-Govdasavvon	Čievramielli-Govdasavvon
Čikŋá	Čikŋa
Čoaigidanvuovddijohkii	Čoaigedanvuovddijohkii
Čoarbealit	Čoarbbealit
Čuodjilis	Čuoddjilis
Čuohca	Čuohcá
Čuorpmotgierragis	Šuorpmogierragis
Čuovzavárri	Čuovžavárri
Čuovzavárrái	Čuovžavárrái
Čuvvovaš	Čuovvovaš
Čáhccesuollo	Čáhcesullo
Čáhppoha	Čahppoha
Čáhppohii	Čahppohii
Čáhčesullos	Čáhcesullos
Čálbmelasiiguin	Čalbmelásiiguin
ČállidLágádus	ČálliidLágádus
Čálá	Čála
Čálálaš	Čálalaš
Čávžus	Čávžžus
čabbát	čábbát
čada	čađa
čadaha	čađaha
čadahuvvo	čađahuvvo
čaga	čága
čahcadaga	čáhcadaga
čahceloddi	čáhceloddi
čahci	čáhci
čajeha	čájeha
čajehedje	čájehedje
čajehit	čájehit
čajehivččet	čájehivččet
čajehá	čájeha
čalbmáičuohci	čalbmáičuohcci
čalgorganisašuvdna	čálgoorganisašuvdna
čalihit	čálihit
čalihivčče	čálihivčče
čalmmastuhttit	čalmmustuhttit
čalmmiguin	čalmmiiguin
čalmmii	čalmmiid
čalmmu-stahttet	čalmmustahttet
čalmmástit	čalmmustit
čaláhusgeainnu	čáláhusgeainnu
čappa	čáppa
čarveniibbiid	čoarveniibbiid
čarvvui	čárvvui
časkadit	čáskadit
časkan	časkán
časkat	čáskat
časkii	časkkii
čatnavaš	čatnevaš
čatnojuvvon	čadnojuvvon
čavgejuvvoi	čavgejuvvui
čazi	čázi
čaziide	čáziide
čaziiguin	čáziiguin
čađaheaigga	čađaheigga
čađahuvui	čađahuvvui
čažiide	čáziide
čeabaha	čeabáha
čeabellii	čeabehii
čeadnju	čeagŋu
čeahpastalle	čeahpástalle
čeahppes	čeahpes
čealkamuša	cealkámuša
čealká	cealká
čealkámuš	cealkámuš
čealkámuša	cealkámuša
čealkán	cealkán
čeavlat	čeavlát
čehpodagaide	čehppodagaide
čehpodahkii	čehppodahkii
čehppodagamet	čehppodahkamet
čhpegolgadeapmi	áhpegolgadeapmi
čibe	cibe
čiegus-vuođaid	čiegusvuođaid
čiehkačivččasteami	čiehkačievččasteami
čiehkačivččesteami	čiehkačievččasteami
čiekča	čiekčá
čiekčamit	čiekčamiid
čiekŋaleamosit	čiekŋalepmosit
čiekŋudanfálaladagaid	čiekŋudanfálaldagaid
čielgekeahttá	čilgekeahttá
čielgásit	čielgasit
čielkká	cealká
čietnjal	čieŋal
čietnjalasas	čiekŋalasas
čietnjalassii	čiekŋalassii
čietnjalat	čiekŋalat
čievččateamis	čievččasteamis
čievččestit	čievččastit
čieza	čieža
čiezajahkásačča	čiežajahkásačča
čikce	cikce
čikŋagas	čiŋadan
čilgasa	čielgasa
čilgejuvui	čilgejuvvui
čilgemeattun	čilgemeahttun
čilgestaga	čilgestage
čilá	čila
čilás	čilas
čoages	coages
čoagga-nit	čoagganit
čoaggánan	čoagganan
čoaggánit	čoagganit
čoahkima	čoahkkima
čoahkimii	čoahkkimii
čoahkimiin	čoahkkimiin
čoahkkai	čoahkkái
čoahkkehus	čohkkehus
čoahkkemii	čohkkemii
čoahkkimasteme	čoahkkimastime
čoahkkimastemen	čoahkkimastimen
čoahkkimistis	čoahkkimisttis
čoahkkimngohččumiid	čoahkkingohččumiid
čoahkkimt	čoahkkimat
čoahkkinortnegistis	čoahkkinortnegisttis
čoahkkánit	čoahkkanit
čoakkanit	čoahkkanit
čoakketkeahttá	čoakkikeahttá
čoakkimin	čoahkkimin
čoakkánmusihkár	čoakkánmusihkar
čoarbbelnorasdávttis	čoarbbealnorasdávttis
čoarbealis	čoarbbealis
čoavddekeahtta	čoavddekeahttá
čohkanlottid	čohkkánlottiid
čohkedit	čohkkedit
čohkkai	čohkkái
čohkkanlottiid	čohkkánlottiid
čohkkket	čohkket
čohkkádusaide	čoahkkádusaide
čohkkádussii	čoahkkádussii
čohkái	čohkkái
čorbmaasturrosaš	čorpmasturrosaš
čorgevahkus	čorgenvahkus
čoskida	čoskkiida
čovddosiid	čovdosiid
čovddosa	čovdosa
čovdit	čoavdit
čovdosit	čovdosiid
črvala	árvala
čujonassaid	čujonasaid
čujuheamiin	čujuhemiin
čujuhuvvojuvvojit	čujuhuvvojit
čujuhá	čujuha
čujuhán	čujuhan
čuo-jahit	čuojahit
čuohca	čuohcá
čuohčá	čuohcá
čuojaheaddjiguin	čuojaheddjiiguin
čuotnjaga	čuotnjága
čuovganeapmai	čuovganeapmái
čuovgii	čuvgii
čuovvavaš	čuovvovaš
čuovvo	čuovvu
čuovvoba	čuovvuba
čuovvogoahtán	čuovvugoahtán
čuovvovas	čuovvovaš
čuozzovaš	čuožžovaš
čuozzuhusat	čuoččuhusat
čuoččilan	čuožžilan
čuoččilii	čuožžilii
čuoččilit	čuožžilit
čuoččuhuvui	čuoččuhuvvui
čuoŋumánu	cuoŋománu
čuoŋá	čuonjá
čuožžildan	čuožžilan
čuožžuha	čuoččuha
čuožžuhit	čuoččuhit
čuožžuhusaide	čuoččuhusaide
čuvge-juvvo	čuvgejuvvo
čuvgehiid	čugehiid
čuvvodeaddjiŧ	čuvodeaddjit
čuvvovaččaid	čuovvovaččaid
čuvvovaččat	čuovvovaččat
čuvvovaš	čuovvovaš
čábbat	čábbát
čácis	čázis
čádnon	čadnon
čágalduhttet	čagalduhttet
čáhcai	čáhcái
čáhcceloddiid-čivggaid	čáhcelottečivggaid
čáhce	čáhci
čáhcebohtala	čáhcebohttala
čáhcelottid	čáhcelottiid
čáhcelottimoniid	čáhcelottemoniid
čáhcerájiŧ	čáhcerájit
čáhcevuoigat-vuođaid	čáhcevuoigatvuođaid
čáhcevuoigavuođaid	čáhcevuoigatvuođaid
čáhpes	čáhppes
čáhppesmurjjiguin	čáhppesmurjjiiguin
čáhppojuvvot	cáhppojuvvot
čáhčeskáluid	čáhceskáluid
čáhči	čáhci
čáilihuvvot	čálihuvvot
čájahus	čájáhus
čájahusa	čájáhusa
čájahusas	čájáhusas
čájahusgovva	čájáhusgovva
čájalmasain	čájálmasain
čájehuvui	čájehuvvui
čájehuvvoi	čájehuvvui
čájehá	čájeha
čájekeahttá	čájetkeahttá
čájálamas	čájálmas
čájálamsaide	čájálmasaide
čákčamánu	čakčamánu
čákčat	čakčat
čálalašan	čálalažžan
čálbmelasiid	čalbmelásiid
čálbmelasiiguin	čalbmelásiiguin
čálbmi	čalbmi
čálbmái	čalbmái
čálgofáláldagaid	čálgofálaldagaid
čáliid	čálliid
čálistiii	čálistii
čálla	čállá
čállan	čállán
čálligoahtet	čálligohtet
čálliiga	čáliiga
čállistit	čálistit
čállojuvui	čállojuvvui
čállojuvvion	čállojuvvon
čállágiid	čállagiid
čállšn	čállán
čálmmeheapmi	čalmmeheapme
čálmmiguin	čalmmiiguin
čálmmostahttit	čalmmustahttit
čálmmosteapmi	čalmmusteapmi
čálmmusteapmi	čalmmusteapmi
čálmmustumiid	čalmmustumiid
čálálaččat	čálalaččat
čálálaš	čálalaš
čáppagirjjalašvuođa	čáppagirjjálašvuođa
čáppá	čáppa
čáppát	čáppat
čáskii	čáskái
čávgejit	čavgejit
čávgejuvvojit	čavgejuvvojit
čávčča	čavčča
čázii	čázi
čáđa	čađa
čáđahit	čađahit
čáđahuvvon	čađahuvvon
čážadagain	čázadagain
čážehiid	čázehiid
čáži	čázi
čážiid	čáziid
čážiide	čáziide
čážiin	čáziin
čážis	čázis
đieđa	dieđa
Šallošan	Šállošan
Šallošat	Šállošat
Šamanaid	Šamánaid
Šilisávžái	Silisávžái
Šjuoššjávrris	Šuoššjávrris
Šlavat	Šlávat
Šukuladá	Šukuláda
Šuoikkážis	Šuoikkáhis
Šuoššjávvri	Šuoššjávri
Šámi	Sámi
Šážžá	Sážžá
šadda	šaddá
šaddai	šattai
šadjái	sadjái
šaddoviessui	šaddovissui
šahten	šatain
šaldii	šaldi
šallosa	šálloša
šalloša	šálloša
šallošahtti	šállošahtti
šallošan	šállošan
šallošat	šállošat
šallošin	šállošin
šallošit	šállošit
šamanat	šamánat
šamanistalaš	šamanisttalaš
šangeris	šáŋŋeris
šattaii	šattai
šattašivčče	šattašedje
šattái	šattai
šealgi	sealgi
šerpenvuoigatvuoda	šerpenvuoigatvuođa
šieahtadusbeliid	šiehtadusbeliid
šiehtadadallanbealit	šiehtadallanbealit
šiehtadallamiida	šiehtadallamiidda
šiehtadallanjođiheadji	šiehtadallanjođiheaddji
šiehtadanbeallálaččat	šiehtadanbealálaččat
šiivui	siivui
šiljju	šilju
šiljjuid	šiljuid
šiljjus	šiljus
šiljui	šilljui
šiltaid	šilttaid
šlavat	šlávat
šlábiridit	šlábirdit
šláhtti	šlahtti
šuohkkiha	šuohkiha
šuohkáhusaiguin	šuohkahusaiguin
šurnalistaoahpu	journalistaoahpu
šáddai	šattai
šáddet	šaddet
šáddá	šaddá
šálddis	šalddis
šáldis	šalddis
šállosa	šálloša
šállosit	šállošit
šáttu	sáttu
šávčča	sávzza
šøvvas	šovvas
ŦMuitalusat	Muitalusat
ŦSančuariŧ	Sančuari
√oktiibuot	oktiibuot
